00010000000010011000000000001001011010001010010000000111100010000000001000001010000000000001000010000
01010000010000110000000000010101000001000000000001010001000000000000100000000000000100011100000110000
00000000000000000000000000000000000000000000000000000000100000100000000000010000100000000011001000000
00001100000000000000010101000000000000100101000001000000000000010001000010000000000010000000100000000
00000000000010001000000000001000000000100000001000000100000001100100000010010001001110000000000001011
00000000000000000001000001000000011000010000000000100001000101000000000000001001100001000010000100000
00000010000010001000010110100000001000001000010001000000100100000000001000011010100100001000001000010
00101000010001000001001100000000000000001010011010000000000000010000000001000000000000000000000000000
10100000000001010001010100000011000100000000010001100011010010000001000100000100000000001000100001001
01000000000000000010000000001000010000000010001100000010101000000000000000000001000000100000000001000
00000010100010110010000110010101010000000010001001000000000100010001000000010000000000100001011101000
01000000101010000000000000100000010000000001000000001010000000001010001010001000001000000100000000001
00000000110000100100000000000001000001100000001100110100001000000000010000100010010000001010000000000
00000010000000000000000000000000000000000001000000001010000001000000100000100001000000000001110001001
01000000000100000101010000001000001000100000000000000000100101000000000001000000000000000000000100001
00100001000000000000000001110100100000000100110011000010100001000100010000010000000000000000010000001
00010000000010000111000010001011000010010001001000000100000000011010011000000100000000000000000000000
00000010000010000000000110000010000000100000000100000000100100001000100000000000010010000000000100000
00000000100010000111000111010000001001000000000000000000000100000000001001001000000100000010010010010
00000000000000000010000011000000010000000000000000000000000000010011000000000001100000000110100000000
10011000000000001000000100000100100000100100000010100000001000000000000101100001000010000000100000010
00000001000000000000111000000001000000101010010000100000000000010000011000000000000110001000001000000
10000011100000100000000010010000101001010000000000000010011001000000100000000000000100000100000100100
10000000000000000000010001000010000000000000000010000000000010000100000100000011100110000000000000010
00000000000000010000000000000010100101000001100000101000000100010100100000000010000010000010010000010
00110001001110000001001000001001000000010011000100000000010000011010011100100010000010000000000001001
00000100010000110000000010000110001100001011000000000101000000000000000100000010010010001000001001010
10000001000000001110100000000010010000000001000000100100000100000000100010000100000001001001000100000
00000010000000000010000001000000010000000100000000100100000000000010001001001000000000000000010000001
01010010000100000001001000000011000000000010000100010100000000000010000000000111010000000000010000000
00000000000000000000100110000000010000001000000001010011000000100000010000000000000001010010100000000
00010000100000000000000000010000001100001000100010000000000000000100000100001000000101000000001010000
00001000100000011000000000110000000011000000100000000000001001001000000000000000100000000001000000100
00000100010000001100000011010000010101100000000000000000100001000010101000000100000001000110010001000
00001000110001001100001000100011100000000000010000000000000010000001000010000000000000000000000001000
11000000100000100000000001000000000000000000100010000000010000100000110000000100000000100000110100001
00010100000000000001011000000100000010001000000000000000010100000010000000010000010001100100000000000
00000000000010000000011000001000000001000000000000000000100000101010100010000000100000000000000000000
01110000010000001000000000100000000100000011010000000000001000000000000000010000001000100001101000000
00001100000000000010001111000000100010000100100100000101010000100000000000001000000000000000001000000
10001100000000000010000010000000000000100000011010101000010000010001000000010001001001010000000011100
00000000000000100100000000000000000000000000000010010000001000000100010000100000100000001000010001001
00001001100011000000000000000100000011100011000000000101000000100000110000000010001010000001000001000
00001000100000001000010010100000000100000000000000110000000100010001100001000000000001000000010100000
00000000010000001100100100000000100000001000000000110001000000000000000100000100000011000000000000000
00100000000000001000001000000000000100000000000110010000100000000001000000101100000000000000000011001
01000010000010000100000000001000000011001010010000000000000001100010000000010010001010000000000100000
10000100000000000000000000010000010000000000000000100101001000000010000010010010000000000000000100101
00000011001100000100110000000001000000100000000011001000000100000000001001100000001000000000000110000
00000000000000011000000010000100000001000000000001110000000001001000000001001000000100000001001011000
00000000010010000000001000000000000000000000100000001000000000000000101010000000000000000110001000110
00000000000001010000000001000010000000000100001101000000000000000000010001000000001000000010010001000
01001000000100000000011000000100000010010011010101000000000000110010000000000001010000000000000010000
00000000000010001000101001001000000010001001000000010111000000010000010000001000110000100000010100000
01000000000000001000000000000001110001000100000010001000100100011000000000000101000000010110000001001
00110110010000000000001000010001000100111000000100110000001001000000001010011000000000100000000110000
00000101101000111000110110011110000000010100001000101000000000100000000000010100010000000000000110000
01100001000000000000001001001000010110000101000001000000101100000000000000001000101000001000010000001
00000000000001000001100000000001000000000000001100000000000000100000010000001010100000000000000101100
10000000100010000000010001000000000010000001110001001000000010001000000010001000101000000000001001010
00000000000010100000100000000010000000000000011000101000000000100100001000000100010001000000010101000
10010100011010000000000100000000000000010010001000000000100000010010000100001001010001000010000000000
01010001110000101000100000001000000100001000100000000000000100001000001000000010000100110000000000000
01111000110000000001000001010000000001000000001001000000000000000000101010000000000011000100100000100
00000000001000000000000000000010010100010000001100001010100000101000011000000000100100000100001000000
11000001100001000001000001111000000001001000110001000000010000000110000000000000101001000000010100100
00000100000000000000000101000010000001000000000000000100010100000101000011000010000000001010010000000
01000000010000010001100000010000011001001100000000110000000001000100100010100111100010100010000000000
01000100010000000000000000000101010000001010000010000000100000000000100000000000001101010000100000100
00100010000000010001000010000000000000101001010000000110000000101010000100000000001000000000100010001
00000110000001000101001000000000000000101110100000000000100000010001000001000000001011000011100010000
00000000100000000000001100000010000010000000000000011000000000100000101000000100001001100100000000100
10100101000001000000011000010000000100111001000000011000000001000000010100000100100001001010010000011
10001000001000001000001001000011010000000100101000001000000001000010000001010010010000000010000000000
00000000000010001100000000001000000010000101000100000000010010000001000011100000010000000000000000000
00000000000000000000100000001000010001000011000000000000001100000000111010000011000000100000000001000
00000000000000000000000000000000000000001000000000100001000001000000000000100100010100000000011010101
10011000001000000110000010000000000100000100101000000110000000001100000001000111100000100000001000000
00000010000000000000001000001001000000100010100000000000001000001001100010000010100000000101000000000
10000000000010100000000100101001000000010101100000001010000100001010011000100001100010000010000000001
00001011010010000000011000010000001100100000100000000000010001000000000000000100010000000001001000000
00000000000000001011000000000000000000000000000000000000110000001001000000100000100001000001001000000
11001000001100000000000010011011000100000000000000010000000001000000010000000000000000000011100000000
00000000000001000000001000000011000000101000010101000100000001010001000000000100000100000011000000000
00000000001000101000110000000010000000000010000000000100001000000000000001000000000000100000010100100
00010000000000100010000010001010001000000100000010000010000000100000000000000101000000100000000000110
11010010010000001010000100000010000000000000000000001000000110010000000000000000001001100000100000000
00000011100000000000010000010010100000100001100000010000000000000110100001001000010001100100001000000
00101000000000000001000001000000001100000100010001000000101000110001000110110000011000000000000001000
00000100010001101000000100000000010000001001000000000000011000001000010010000000001000000100000000000
01000010000100011000000001000011000000000101011000101000001000101000000001000100100010000000100100000
00000000000000000010000001101000100001001100000100000000101100000000000000000010100000000011100000000
00100101001000100100000101000000000000000000000000110000000000000001000000000000000001000000010000000
00001000110000000000000000000000001000000000010000000000000000110011100010110011010000000000000100000
10000001011001000000000000010000000100000001000001010001000011001000000000000000000000011001000110100
00010000000000000000110000010000010010000000001010001000000000000010000000000100010000001000000010111
11010100101011000000001000000000010010100000000000001000100100010010001000000011101010000000000001000
00010010000001100000000001000000000001000000100000000000000000100101010000101010010010001001000001010
10101000010000100000011110010000000000010000010010010001011001010000010000000000101000000000000100010
01000001010000101000000100100000000000010000000001001010000000000000010110101000000000100101000000000
01011100100000100000000000000001011011000000000000000000100010010001000001001000001010011000000011000
