01000000001000000100000000101010000000010010101000000000000010100000000001000000000011000000000000100
00001001001000000000001000011100100000010000000010001010000100000001000100000100100000000100000010000
10000100001001000000100000000010000000010001010000001000010001000000110000000010000110000100000001000
01000100010100000000000000110000000000000000010010010000000100010100010011001100100000000001010000001
10000010000001000010001000001000010000100111000001000001100001010001100000100000000000010000000000010
00000001101000001000000000010100100000101000000011100010000000101000000000000001000100101010000010000
01000100001000000000100000001100001000000000000010000010100000001000001100001001000001000000100010000
01000000001100010000100100010000010010111001001010001010010001100001000100000100000000001010011100001
11100100000001000100000010000000000000111000000000000000100001010001001000000100000100001000010100000
00010000100100000011100000000100010111010010101000110000000000100000000001000011000000000001010110100
00000000010000001000000000000000001001000101010001100000100010000000100000010010100000000000000000010
00000000101000000000000000001000100001000010000000000000000101100000100000000000001000010100010000000
00000000000000010000100001000010000000000100000010001010000001000100000010001000000000000000000100000
00100000000100000000000110000001000001001000000100000010011000010000000010010010010001000100001000000
00100000000100000010000000000000000000000011001100001010000010101001100110000000000001000001000000101
00111000001010000010110100000011000000110001010100110010000000100000000011000000000100000000000010001
00000110000000100111100000001000000000100011000000100100011100010010001001000000110001000100000010000
01010000000000000000000100000010000001010100001000010100000000010000101000000000000000000000000000010
00000001000100000100000000001001000000000000000000000110000001000010000000001000000000000001100101100
01000101000110010000001010000000010000000000000101100000010000000000000000000111000000001000000000100
10000000000100011000000001100100010001010001000000110000000000000000000001000100100000000000011000000
00001000001010000111001010100000001000010000100010001000000000000100101110000000000010000000000001001
00000000000000000010000000000100011000001000000100000001000000000001000000000110110000000011001000000
00000001010100010000000011001000101010010001000001001001000000000100100000000010100000010001100001000
10000000000000000000010000000010010000001100000000010100010000001000000001000000110000000000010010100
00000000000000000001000010000010000000000001001100000000001000010000100000000100000000000010001000110
00000000110000011000101010000011000010000010000010010000010000100100110010000001010000010010000010101
00000000000000000101000010100010100001001000000001000100010000000001000001100000010000010000000000000
00000000000100000001000010100010000100100000000000000010000000000000100000001100010100000100000000000
00000000000000100000100000000000011000001000000000000000001000011100001011000000001000000111010000100
00000000000000011000010100001100000000000100110010000000000000000100000000001000000000000011000000000
00010000010000110000000111000101001010000100100000000000000000100000000001000010100010001100000000001
00000100001001100100000001000000001000000001100000100000100000100000100000000000001000000001001000000
10000010100010000010000000010011000100000100000001001000000000010010000110000000000110010000000000000
00000010001000001101000000001100000010000000100000011000100000000000100000000000000000100010000000001
11000000000010001100000000000000000000000000100000000000000000000000000110000001110010011001100000000
01000000000000000001001000000110010001000001000000000110000000100100000100001010000000010000001100000
00000100001001001000001000000001000001100000000000010000000000000000000000010100110100001100000000000
10000001010001101000100010000001010010000000001000000000000010000000001011000000010010110000000111010
00000000000010000000000000000000010000000010010000001000010000000001000000000000000000000101000000000
00000000000000000010000000000000100000101100010000010000110001000000001000000010000000000000100001001
00000001001001010000000000000000000000100001000000000001001000000000001000010010000000000001101011000
00000000100000000000000000101111000100000000000000110000010000001000010000010100000001000100110000000
01100000000110110100000000100000000000000101010010000100000001001011001000000000000000000000001000000
00010000010001010000000001001000000000000001000000000011000000000000000010000000000001000000001010101
01000000000100010000010001011000000000000000000110000000000100000000000000000000010100000001101100000
00011000000000000000000110010000110000001100000000000010010001000000010000000000000100001000001010000
01000101000010010000010001000010010001000000100001100000000001011100000100100000001000000000100000000
00001100000000001010010000100000000001001000000000000010000001011010000001101100000100000000000000000
00000000011001000000000000000000000000100000000001000001000000100000100000000000000000001100000000101
01101100001000010000000000000000000000000000100010001000000010100110010000001000000000001000000100000
01000000001000000000001001000000010010000100101010000101101000000000000010001000000001000001000000010
00010111011000000000100000111010000011000101001000001010001010110001000100001101000000111000000110101
00000100000100010000101000010001001000001100000000000010100010000000111001000010000000001001000100100
10000100000010100000011100001000000000001001000000000000101001000111000000000000001100101001000100000
00000000001001100000100000000000010100100001100000000010000000010000100100001000110001001100100100000
00010000000001000001100110000110100000000000000000010011010001001001001000000000100000000000000000000
00100000010100000000001000100001001000000111000100100000000000001010010001100000001000000000000000000
00001000100000000000001000110000000010000011110000011000010001100100000000000100100001000100000000001
00001000000010010000100100110100010000000000000000000000010000001000000000000001000100000001000010001
00000000010000000000000100001000010101001000000100000100000000000000100000001000001000000000000001101
00000000000000000010001000011100110100000001000010010000000000100010000001000100001000100000000000010
01010100110000000000000010000000000001000101000110110100100010001000100000100010010000001000000000000
10110001001000101001000000000001000001000000100000010000011101110000001001000010000101100000000000000
00000000000001000000100000100000100000100100000100010000000000000000000101010100000000100100010000000
00000101000011000010101001011000000000001001001000011000000100000000000000100000000000011001000001010
00000000010000001000001000010000000000000000000100000000000000000000110010000100001000010100000000000
10000001000000000010110000000000000000000011000001100000000000110000001000000110010000000001001001000
00000000110000000001100010010000000000000000000000100010000100000000000111100000000000100000000001000
00010000100101000000000001001000100001001010001000010010000000101100000000000100010101101010000000100
01000000000100000010000100000110010000000010000010001000000000010000001000100000000001000000100100000
00011000000000000001100000110000000000101000011000010100001000000100000000000011000001000000100010000
00010000110100110000011000000100000010000000000000000000100110010000000000100001000000000000000000000
00001010100000000100000000100011000000001001010000000110000000010100000000110000000101001001010010000
10000100000000110100000001000010000000101010000000000010110100010010000000000000110000000001001110000
01010000000000000001000010000001000000000101000001100000100000000000001000100010111000100000000110000
00001000001000100000001010100000100001000000010000001100100000000000000000010010010000000010001000010
10110000000000100010000000000000000000001001001000001000000000010010000000000000100001000000000000110
00000010000100000000000001101001110100000000000010000100000000000001010010000000100000100100001110000
00110000010000000000000000100000000100010000000000011010000000000000100000010000011000000000000000001
00000010000000000010000001000010000011001011000000001000000010000001100000000001001000000001000000000
00000010000100001010011000000000100000000010000000010000000100000000000100000000000010011000000101000
00010000001000100101000000001110000000000000010000100000100000001000100011100100000100100101000001000
00000000000000010000000100000001001000001000000110001000010110100000110000100001001100101000000000000
00000100000001000001010001010000000000010100001010000000100101110110000001010100000010010001100001000
00000001000110001010000000000101010001000001110000000001000111000000001000000100000000000000000100010
00001000000110000000000001010000000010110000010111111000100101000000000000000000000100000010100010000
01100011100000001001000001010000000101110000000100000000000100001100000010000000100000000001110000000
00000001010010000001000000100010101001001100000000001001101001000101010001001000000000000000000000000
00000101010000110000000000000001001000100000000000000000010000000110000100000000000001010000000010010
00000100110100000000000010000110000000000000010000001010001000001000000000010000000010101000000000100
00001010000000100010000100100010000000111100000100000000010000000000000000000000000000010000000000000
00000001010000000000110000101000001101000001011010000000000000001101100001000000010010001010000100000
00000000010001000100100000000000010100000001000000000000010100000000000000000000000000000000000010000
00000000100000000000100000000001000000000010000100100000010000010000000000000001101000010010000000100
00001000000000010010000000000000001100000000000001001000100001000100000001000000000001000000000011000
00000010000111000000010100000000010000100100000010000000000100000010000001010000000000000101100100010
00000000100000100010000000011000001010000101011000001010011000000010000000000010100100000100000100000
00001000100000001000000000000100000000000100010000000100100010000000000100000000000000011010010100011
10100010000000000000100000001000111000000001100000000000000010000000000110010000100000000000000000000
10000000000000010000000000000000000000000010000000001000000000010000100001000100000000000001010001000
