00000000010001000010000000001000001100000011100001000000101000000000000010001000000001000001000001000
10100010010100100010100001100000000000001000000000110100000000001000101001101001000000100010100000000
00001000100101000000000011101000000000000000100100001000000000010001101010000000000011000000000000001
00100000011000000001000000010000100011001011000011100010000110000000100000000011000000000000101100000
01000000000000000000000000000001100001000011001000000000101010000010001000000000000000000010101000000
00000110000010000001011000000000010000010010000011010000001000000001000000100000000000000000110001000
01000000001100000000001001001000100000100000000000011000000000100000001000010000110100000001000001000
10001000000101000000000000001101010100000110000001000001000000010000011000000000010001100101101010001
10100000000000001000000011000000010001010000001000101011000100000001000000011011000000000000010000000
00010000000001110100000000001100100000001000000000000100001000000000000001000000000000001000100000000
01001000000101000010000000001010000000000000000010100010110101100000010000000000000000000111000000001
00010010100000000000100000000011110000011000000010001001010010000011010010000000000101100000000000100
00001100000000101001010001000100000000101001000000001000000100010000100001110010110100001000000101000
00100001000001100001010001010000100001000011001000000110000010011000000001000110000000000000000001000
10000010000000000001000010000101000001010001010110100000000110010000100000000101000000001000001101100
11000000000000010100100000100000000100000110000000010001000000000010000000001110000000001010100010000
10000000000001000000001000000000111001000010000000001110001000011000100000000000000000010000000000000
00101000010000000000000110001001100010000001000001000000000000000001000000000000000000001101000000000
00000010000100000000000000101001011010101000101000000001000000000010000001110001100110000000000011011
10000100001000000001000010000000001000000110000010000000001001000000001001111100000000001010011100000
00000000001000001000101000010001000000000000000000000000001000000001000000000000001000000000001001100
00000000000010000011100000000110100000000000100100010000000000110000001000010100000100010100000010100
00001000000010000000000000000100110100100000000000000010000010010000000000010100000010100000010000011
00010000011000100000000000100001000001001001000001000100001010010000100000100100100010000000000000010
11000000000000010000100001001010000010000101000001001001000000100010010011000000000100101000100000000
00000101000000101000000100000100000000011000010000000000001111000000010000000010000100000001100010000
00000010100101100100001000001000000010000001001001010001010000000100100101000001000010001000000000000
00010000000001000000100000011000000000000001101110010100000001000000100000000000100000100001000000100
10000100000001000100010000000000000010000001000000010000010100000110111100000000000000010000010000000
00000000001000000001000000000000010001000000000000000010000010000010000000000100000000000000000000100
10000011110000000000001000000000000000000000000000110000001000010000000100001000001101000100011000000
00000001001001100000000010100100100010100000000010000001010000000000000010000000000000000000000011000
00000010000100000100000011000000000010001001000000011000100100000001101000000010010010100010001000010
00001001000010000000001001111000001100000000000000000000000001000100010010010000011100100000100100000
00010100110000100010000000000000010000100000001000000000000100000000000100001010000101000100000001000
00010000100110000001001000010000000000010000000010010000100000001001001000000000000011001000000100000
00000000000000000000111000000000000001010000101000010101100000110101100010000000010000100011010010000
00000001111100000000100000000010000010000000011001010000000011001000000001100100100000010000000000101
00000001010010101000000001001000000001100010010010001010000100000001010000000010100100110010000000010
01101101000100000110000000010000000000000010000001001000010001000000100000000000000000100000001100100
00000100001001000000100000101000100000001001000000000010000000000011000000000000000010001011000000001
00000001001101100000000000010000000000000000000000000001100000000010100000110100010010001010000000000
00000010000100000000000000010101110000000000101011000000100000000001000101001000001010001000000000001
00100010000000000000000000010010000000000001010001001000010000000000100000001000100000000100000101001
00000000000000000011000100001000000000010010101000000000000001000001000000000000000000001100010110010
00000010110000000110000000111000000000000000010000010101001010001000000000000000000001000000000010000
00000000010000001000001000000000001010001000001100100100010000000010010010010001000000010000001000000
00010000000001001001001000100000100000001000110100010010000110000010000000110000010100000100100010001
00000000100101100010001000000000000101011010100010000010001000000001000100100000001000010001011010100
00111001000001000000000000000001000000100000000001000010100000010000000000001000000000100000000111101
00000000000100001011000000001110100100001000000000100010000000000000010001010100000000000011000010001
00000100010000000001000000000010011000000110100000001000001000000000000110001000000010010000110010001
00000100000000000100000000010000000000101000010010001001110000000000000000010000000000000000000110001
01000000000000001000000000010000000111000001010001000001010000100010001000000000010010100000000000000
00000000000001001000010010000001110011010001000000000000010000000000001110000100001000000000000000001
00001000000001000000000010000000000111001000010000000000000110100000000000011000000000010101100000011
00100001000010001000000000000000100011010000100001100000101001000000001001001000001000101000100000001
00000000000000000101100000000000010100000000010000010000010100000011000010001000000011000000001000001
01000000000000000100000000100000000000100100101000001010101110000000110000001000000000000000101000000
00010001100000010100110000000000000000001010010000000010001001000010100011000100000010110101100000000
01111000000000000000000100000000000100000001100011000000001001000000010000010010011000000010010000000
01000010100000000000010100010000010000001001001000100100000000000000010100100000000010000100000001000
10000101100001000000000010000100010000100110000000000000010000000001111000100100100000000010000000010
00000000000000000010000000000100010000010001100000000100100000000000001011000001000000000000000000100
01011000000000000110010000000101000000000000010010010000001100001000001010000000001001000000010000000
01000000011001110000000000010000000010011000000000011001000000000100000000100011000000000000000110000
00010000001000001000100100000000100001000000000000000010001000100110000001010000000000000000000100000
01100000001010000001000010000000010010000100010000110000000000001000000000011111000011000110000010000
00000000000011000000000000100100011000001000000000000010000000111010100010000000110010100110000011000
00010000100000000000100001000100001010100001000010000000100000000000000001000010000000000001001010001
00010001000100000100000100000000101000000000100000100000001100110000000010110000100000000000010001011
00010000001001000000000010100000100101010001000010011000000000000000001000000100001001000001100101000
00000000000000010000100000110000000000000000100000000001001100000000011000000000000000000100000000100
00110010000010000000100000001000010000000010000000000001000000000100100000100010000110001000100000000
00000100010010101000000000001100000000101010000001110000000000000000010000000001100000000000010000010
00001011000001010000000000000100100000000000100000000000110100010001100000010001000000010000010010000
00010000010100001000000000000001000010100110010100000000000000010000000010000000000000010010100000100
10010000000000001000000000100000000000000000000000100100001000000000100000100010000001000010000010000
00100010000100000001000000000010000100101000000000000000000100000001000001001100000000001001000100100
00010100000001000100001000100000101100000000000100000000100101100100000000001100000110001000000000000
00010000100000010100101010000000001000110100100100000000010010000000000000000010000000100000000010010
00000000000010000000000001111000000000010000000001100000100100001010000010110100000000000011000001000
00000100101001000000000000000111000000000010000000001010000000000000000000000010010100000000000101001
10000000111000000000000110100000000100000000001111000100001100100000000000000100000010000000100001010
10011000000000010000000010000001011000000000000001011100000000000000000001000111100000110001010000000
00010000100110001101000100001010011000000001100000000001000000100100000001010000000110000100011001010
01000000010010001100001000000000000000100000001011100010000001000000000000000000010000000000000001010
10001000010010001001000000000000000111110010000100000100000100001001010010011000001000000000100010101
00000011000100000000100000010000010000000001000000010000100000000100000010011000000101100010001000000
00010000001000001011010000001000000000110000000010000000010100100000000010000100000001000000011010100
00000000100001010001000100000000010010000000000000001010000000001001100000000000000001000000110000000
11001001000100000000000000000100001000100000000000000000000000100001000010001000000011100001110101000
01010100000000000000110001000001000000000001000100001000001100000000000000000100000001100000000000001
00000000000000000010000100000001000010010011010011001100000000000111000000000000010000000100000001000
00100000000010000011000000000001001000000000000001000001000100000000001001100000000000000000000000000
10010001000000000001010001010000000011000000000000000001110010001011001100010000010000010000010000000
00001010011000000010000000000010011010000011000110001010010110000000001000000000100001100010001000100
00010000000100000000000000001000100000010001100000110100010001000100001100010101011000100000000000111
00000000000001100011000000000100000000100000000010010000000000000000010000000001100000010100010000001
00001000000000100000000000000010000000000000000100000100011000100000000010010000010000100000000101000
00101010001000000000000101010000000000010000000001000000001000000011000010000110100000000001000000000
