00010001000000000010001110000000010000001100010100000010100110010000010000000101000000001001001001000
00000000001100000100100100101000001101000000000000000100110000000000010000000100000000100100100000100
00000000000000001000000010000100000000000010000000000101010000010000000100000000000011000110001100010
00000000000001000000000100000000000000000011001001000000000000100010011000000000111100100010010000000
00000000000001000110000000001000010100000000000010010001000000000000000100000000000110100010000100000
00000000010000000000000000110000000001010000000011000000000000000000000001100110100000000101100000000
00000000000010011001000001000101000010001001001010001000000000010100000110010000000000000000100000000
10001100101000010000000000000000101100011000001010000000000000001001000000011000100000000000011110000
00100001100010000000001100001000100000000000001000000000000100010000010000000111000000100111011000000
00010000000100001010000000100000100000001000100000101000100001000001010000100000011001000000001100000
00001010000001000010010100000000000000000000000000000001001100000000000000000000010010010011000000000
00001000000000001110000010001001010101000100000011000001000010000000000110000000000000000000000101001
00000100001000110001001100000000000000000000000100000000001000000010010000001000000000010000000000010
00100000000011000000100000001000010100000000001001000100010110000100001011000010000010000000001000000
00100000010010101001010000000000000000000010110110000000000000000001001000000000000010001010110000000
00011000000000010100000100100000000010000000000100000110000000000000000010001000000001000000010000001
01001000010000000011000000000100000001000000000000001000000100000000000000000000010000000000000110000
10001000000001000001010000000000000100000010100010100000010000100001000000010010000000101000100000000
00000000000010000010000100000000000001101010000000000000000000000100010000000000110000000111100000010
01000101100000000011100000000001001010000001000000000000000000000000100001100000001000000000110110001
00000001000000000100000000000001010000100011010000101110110101000000000000100000000000100000000100000
00000110010000000000000000000000100001100100000000000001100000101100100000100001010100101100000100000
00100001000000000010000000001000001010000101000000100000001010001100000010000000000000000000010010000
00001110000000000000001000100000000000001000000000000000000000000000000000000000010010100110000100010
01011000000010000000000011100110000001000001001010001001000100000010001000000000100000100000000000100
01000000100010000010011000100011000000010001000001000000001100000010000100010111011001001000011000001
01000001000000010100000000000011001100000000000000100011000000101000000010000000010000100000000000100
00010010001000010000000101000001110000000000100100000000000000000100000000000000000000000001000000001
00111000100000100000000000010010000000000010001000000000100010010000000001000000100010010000111000010
00000000100000000000110000001000000000100000001000100000000000001101000000000000101000010000011000100
00010001001000000101100000001000010000000000110100000000000001000000000000000001000000110101011000000
00000000000000101000000011001000010000011000000000000100000000100100000000001010100000100001000100101
00010100001001000000100000000000000011000000000100000100000000000000000001000010000000000000001001010
00010000000100010100000000000000001000101100100010000000010000000010000000100000000000011010010001010
00010010000001000000000001000000100100010001000000000011000010000000000100010010100000000001100000110
01010100000001110000000000010100010001000000000000000000000100101000010100000000000011100000001000000
01010000000100000100000000000010000000000011000100101011000010000011000010001011000010000100000100000
00000000000100001010000100010000001011000010000000000001000000001010000010000010000000000010000100000
00110011000000010010000000100110010000000000000110000000101000000000000000000010010000000000011000010
10000001000011000000100100000000100100000000001000010010000000010000000000101000100001000000000001000
00001001000000011010001100010110000001000100101000000010000000000101000000100000000000001100100000000
00100000000000000000000100100010011000010001100110000010000010000000000000010101000000000000001000000
10000001100000000000000000000000000100000000000000000000010000100101110110000000010000000010000000000
00100000000000000000000000011000001101000000000000010000100000010001000000011110000010000111001110000
00010000000010000000000101000001001000000100100011100001010010000000010000000101010000011000000000000
10101000011001000000001000000000010000000001000000000100100000000000000011001001000000011010100010000
00010000001010010000000001000000000010000100010000100000010010000000000000001000010101011001001000000
00000100001001000010101000000000000001000000000100000000000000000001000000010010000100011000000100000
00001001001101000000000100000000000000001100100100000000010100000000001000000111000000000010110100010
00010000010010000000110010011000000001000100000010110000110000000001001100001000011011010010001011000
00000000000001010000010100000011000100000010000000011001110000000000000000010000000000010000000000100
01010001000000011000011000101000000000001000010000000000000000000000000000010010011100000011000000001
00010000000000000010001000001000101000000001000000100000000100000000100000110000000101011100000100000
01010000000000000001000000000000100010100000000100111101010000000100010000000001100000100001000000000
00010011000100011000010000110010000100101001100100000000010000000001010000000001100010010001010000001
01001001000000010000000000100100001000001000010100010000100001001100000000001000000001010101000000100
01000000001001001010011000000010000010000000000001000100100000000100101000000100110000000000000000000
00000010000000010011011010101000011000000000000000100000000000010000100010010100110011000110011000001
00100000011100010000000000000000100000000100000000000000010001111000000001000000001101100100000000000
10001000000001000101100000001000000000000000010001010100101000110000000010010101000000000000000000000
00000000000000000000110000000010110000000110000000010000000111000100000000000100011000010000000100001
00000000100000000000000100000100110000000100000100100011001000100011000000000000000100000001100000001
01000000000000010000111100000000001001001100010000010001000000001100000000000001000000010000100100000
00000001000000100000010100001010100010000000000001000001000100000000000100000000010000000100000100000
00000000000000000000001001000001000010001100000000000100000010000000000011000000100000100001010000100
00000010001000000001000010111100001000010000011101010010000001000000000000000000000000110100000100001
00000001000001100000000000100100000001001100000000001001010010011000000000000000000000000010010000001
10000100110000010000010000001000000000000010100100000000100001001111100010000000000000001000011001001
00101100000000000010000010011000000000001000010000000000000000001000000000111000000000000111010010010
00100000000001100100101000001011001000000100000000000000010100000000001001000100000000100010000100000
00000000000011000101000000000000000000000000000000000000000000000001000000000010000110000000000000011
01011000001010000010010001010000000000000011011000010001000001000000000010000000000010000000001100000
01000110001101000000000000010010110000001000010000000001000100001000000001001000001000101000000000110
00101000000000100000100000000100100010000000000001000001000001010000001000100000001000000000101000001
10000000000100000000000010010010000000001001000101000010011000000000001010000000000011010000000010000
00000000001000001010101001000000000010000000011010000000011000000000110001001000101001110110000001011
00011010000000000001000010000000001000001010000000000010010010100010000000000000000010011000001000000
00000100000010000001000100000111000000000000000001000000000101000000000100101000001000000000000001001
01000001000100100000000001000000000000100000000000000010000000001101001001100000100000100000000010000
00001000001100000010000000000010100000000000000110001100010000000000000011000000011000001100000000001
00000000111000010000000010000000000111001000101010100000000000100000100000000000000000000000000000010
10000001000000000000011001000001000000001001101001011000001100010000000001000100110011010001010000000
10011000001000010000101010000010000011000000010000100000011110100101001001000000000110001001000000000
00000000010000000000001100000001010000000000001000000000110000000011001010000000010010000001100000000
00001000000000100000100000000000001000000010000010010001001101000001000000000000010100000000000101000
00001000000000010000000000001000001000000000100100000100000000000011000000000000010011000000100000010
00001100000000101000000000000011000000001000011010001000100000000000100000110010101001001000110000000
11100000000010000010000100010010001000010101000011000000010010000001011000011000000001000000000001000
00100001010010000000001101000010000000010000100000100010000000010000000010001010100000100000100001000
00000000100010000100010001000000100000000000100100000000100000000001000000000000001000000110000010010
00001011010000001100001000001001000100000001000000000001010000000000110000000000000010000000000000000
10000001010000001000100000000000000000000100010100000000100000011000000000000100100000001000011000100
01010100000001000000000100100000000000100000110000000100001000010000000000000110000000100000001000000
00100010001000000100010010000000000000000000100001000000010010000010001000100000010010000000000000000
00000010000010010001001000000100010100001000000000000100010000110000000000100100000000000001100000001
10100100000000100101000010000000000100000000010000010011000000100100000011010000000000011011000110000
10000000000010000100000001010000000001000010000111110100001000001000010010000000100000001100000100000
00011000001000100000000000000000000000000000001000000000000001110000000000010001000101001000100101000
00001001010100000000000010010010000000010000000100000000000000100000100000100101000100000010000000000
00000010001000000100010000001001010010010001100000000000010011010000000000000001000000000000001000100
00000000000000010001110000110000000000000011100000000000000000000101001000100010000100000100001100100
