00100000001000001000000100000100011010010000000000000000010101010000000000000000010001101000001000000
01100001000001001010000100100000100001000001010001010100000010100000000000001000000000001100000100001
00000001000001000000000000000001000010010000100000000000100001001000010000000000000001000000001010001
00001000000100001100100100100110000000000000000000010000000000000010100000000000000000100000001000101
00000010010100000001000000000000000001000001000000011010000000000001001000000000000000001000000000001
00110010001010000000000000001101110000000010100000010100000000000100011100100110001000001001000100001
00000000001101100000000001110000010000001010000010100000100000000010100000000000000000000000100000001
00000000000000000000000000010000011001010100001001010000011000010110010010000000010100001000100010000
11001100000000100100001101000000000000010111010010000000100000000111011000000000000000010000000000001
00000100000001010000010000000000100000000000110000000000000001001010100010000001100010000000100000010
11000100000000000000001000001010000000001101011011000111000100000001000000001000000000000000010001000
00011010010100000000011100000011000010000000010100000000000000110101001000000001000000000000000001100
10000000100000010001100000001000000000110000001000110000000110000000000000000010000000000000000000001
00000010010000010000100010000000000100000010000000010000000000000010000000001000010100000001101000000
00000000100000000000000100000000000010001000000000000000100110100001001001000010000010001000100000000
00010100000001001000000001001100001000100000000000000000000000000010000010000101100011010000011000000
00100000000000001000000000000000000000000000100000100010000000001000010000000000010010010000100000100
00001001000000100000000000100101000000110000000000000000011000000000000000010000000001000000100000001
00010000000000100000010101000000010001000000000011001010000000100000000101000000000000001100010100000
10000000000000000000100000000000010010000100000000000110001100000000000100000000000000000000000000110
00000000001000000000000000001000100100010000001000000011111000100100001000001110000010000000000000001
00001000000000010000100010001011000000001000000000000010000001001000010110000100000010000100000100101
00000000100000000000000000000100100000000000100000001001000010001000010100100000000000000010000000100
00001110000100000000000000010000000000000000000010000000001011001011000000100001010010000000000000001
00000000000000010000000010100000000000100000000100010011010100000100000101010001010000010000111000101
01000000011010100100000000010001000100110000100010000000000001000000000000000100000100011100101000000
00000000011000000000000010000101001010000101000100001000110000100011100000100001000000010010101000100
00000000000000001000000000000111000100000000000100010000000001001000010001000000000100000000001000000
00000001000000100000000100001000000000000000000101010000000000011000100001000100001100100001000000000
01010010000100010000010000000000000000100100111100000100001101010000000011001000000000110000000000110
00000100000101000000000011010101000000000000000000100110000000001001000001000010000100010000100000000
00000100000110000000000100000100000000000010100000000101010000000101000010010000001000101100001100010
00000000000011001000000001000011000000100100010000000100000000000001000000000111000100000000110001100
00010000001010100100000010010010000000010000010000010011101000110000001110000000110010110000001010000
00000000000000000000000100011000010001101100000000000010000100010010000000011100000010000001100000000
00000000000000010000000000001000000000000000000101100000000000100100000010000010010001000000000100000
00011000001001010001100000000000000000001000001011000010010000100110010010100010000100000000000100000
10110001000000100100000000101010100000100000001000001100000000001110100101000000000000000000000100010
00000000100000000000000010000000100000001000010100000001000001000001001000000000000000000100000010000
00000000010010000000100000100001010000100001001000000000000100010000000000000000001001001010000011000
00010000100000001000000000000000000000100000000000001010001001000100010100000000001010110010010000000
10000010000010000000100001001000000000000000101000000101011001001010000001000000010100000000010110010
00000001100000010000000000011000000010000110000001011010001000000001000000000000001001010000000000000
00000010001000011001000000000000000000000000000100010001000000000010000001100010000100001000010001000
01000000000000000000000000000010000000000000001000000100011000010000010000000000010000000010000000001
00000000000001010001110001101110001000000100100100000000010000100000001001001011001000000010001000100
01101000000100000100000101010000000000001010000100000000110000000000000000000000100101000111100000001
01000001000010100110000000000000000000011000000000100000000000000000100000101100000000001000110000100
00000000010100001000001010000100001000000010000010000011111001100001100100000000100000001000000001001
00001010000000101000000010000000001000010010000000000010000100001110000001000010111000010000000000010
00000000010001001000000100000010000100100000000000000000100000000000001000100110000000000000000100011
10010010011000000000000000000000000110001100000000010010000000100010000000000001000110000000000100110
00000000000000010010101100000000001001000000000000000000000001011000000000100001000010000000001000000
00000000000010000111000000001000000000000010010010100000001000001011000000100000100010000010000001000
00010100000000001001000001000010110010100000001000000000100000000101001000010010001000000000111101000
00000010000000000000010110001000000000100000000100001000000000100000000000000001000100110000000110101
00000001000000001000100000001000000100010000000000000000110000000000001010000000000100000001001000000
00011010001000000100010101000000100000000000000000000011100100101100000000100000000100000000100000000
00100010000000000000001000000000100001000001000001000000010100000000001000000000000000010000000000001
10001000100000000000100000000001010010010000100010000000000000000100100000000010000001001010000110100
01000000100001000000000010001000100000000100001101000000001000000001000100010000101000000011011101010
00000000000010000000010000000001000000000000000000000000001000000000000001000001000010000001000100100
00100000100000011010100100110000000000000101100000000000000000000000001001000000000001010000101100000
00010000000000000100010001010001000000000000000010010101100000010000000000000100000111101001010001000
01000001000000000000110100010001000001111101011000010001000001000001010001100000111110100100001000000
00000010000000010110100010010000000000100001000000000000100010001100000000000100001000001000000101100
00000000000000000011000011010000100100000000000000000100010000100000011000011000101000000000101001111
10000000000000010010110000000000000000010111000010000100000000000000000000001000000001000110000000010
00000000000000100011010101101100001100000000000000100000000010000000010100110010000000000000000100000
00000010001000000100001000000001000000000100000000000000000000000010000101001000101000010000000100100
01010000000010010000010100001000100000000000000000000000001010000000000000000000010011000001100000000
01000000000000100000000010000010010000000000000000000000000010001000000000000000010000100010000000000
00001100000001100000000100000000000101000000010010010010000000000001100000000010000000010000000000000
00010100000000001000000000100001000100000001010100011110001110000000010010000100000000001000000000100
01000001000001000101000001001000110110000010000000010000100000000000000000100001000001000000000000000
00100100100000010000001011000001000001010000000010000000101111000010000010000000000000100000000000000
10000000010000000100001000010000001011000000000000000010100000000010010001000100000000000000010100000
00000000001001000000000000100000000000000000001101011000000000000000000001001000101000001100010000100
00000001110000000001010010000100110000001100000111010000010000000000000000000100001100000000001000000
00000000001000010010000000000010000001000010100000000000000000010000010011010110000100000100010001000
00001110000000000000000000100001000001001000000000100010001000000000101000000000100000000001000000100
10000010000011100000000000000001010000000000000000000010000000010000010000100000000000001100000000001
00000000010000010000001011000100000011000101010010000000100100000000010000000000000001010000000100000
01000010010000111001000000000100100000010000000000000000001010001001000000000000010000000000100000110
11000010001000100000000000000000101001000000010000000110000001001000010001000000010000000000010000010
00000000000010000011000100110100000000100010000000000001001010000000001001000101000000000000000000010
00100101000001000000000000100110000000000000000000000000000000000101000010000010000000000000001010000
01001000011000101001001010000100000000000001010100100110000000000000111010000110000101000100110000000
00000000000010010001101000000000100000000100100000000100000010011000100000000000001000010000000001000
00000000000001001110000001010000100000000000000100000000000000001010001100010000000100000000100011000
00000000001000100100001000000100010011001000000000010010110100001000010000000000000000100000001000000
00000000101000000000000000000100001000000000000110010000010000001000001000100100000000010010000000010
00000010100000000101000000000010000000000010000000000000000010001000100000100000000100010001000000000
10001000000000000000110110100000000000000000000000010010000010000000000000000000001000101000010010010
10010000100000000010001000000011000110000000001001111000000100000000000000000000000000000000000011001
00000100000000010001100000000101010010000010010000000001000000000000010000000000000000100100000000100
01001010000100010010000001000100000001000100000100010000000000010000101000000010001000011000000000000
00110010000010000100000100110001000001000000000000011000000000100000100010000000000010000000010001000
00000000001100001000110000100000000001000000000000000000101000100010000000000000000110010001000000000
00100001000110100001000000000000000000000100010000000011000000000010001000000000000011000001100100001
01000001101100000010010000000010000000001000001000000001000100101000000000001100110000001000000000000
