00001001001000000000001000000000100001011001000110100000000101110010000000101000010100001000000000000
00100100000000000000000000000001000000000000001010000000000010010001000110010001010111000000010000010
10000100010010000000000000000000000000010100001001000110100010100100000000000001010010010000000000001
00001000000000000100000010000000000110000100000011000000100000111000001000000000101100001000001000110
11000011000001001010000001010000100010101000100000001010000000100011001000000000000000001000001100000
00010000000000000100000101010000000000110000000010010000000101001000000000010010000000101000001000000
01000000010001011011000001010100000100000011110001000100000001000000010000001001000000000000010001000
01100010000000010010000000001101010010000000000000000100000001100000000000000000001001000000000000100
00000000000000100100110010010000000001000000010100001001000000000100100110000000100000010000000100000
00000000000100000000000000000001000000000000000000000000000000000010000010000000101000100000001000000
00110000000000100000001000001000000000100000010000000000001101100000000010010000000000000000000000001
00100000000011101001100100000000000100001000000000010000000001000000000000000000010000000000000000000
00111100001000000000010100001000100101000001000001100000001110000000000000000000000011010001000010000
00100000100000101000000000000100011000100100000000000000010000100000000000001010000000100001100001000
00000010000000000000000001001010001000000000000000100000000010000000000001011001000000000000000010100
00100000000010000000000000001000000010000100001001011001000100010010000001000010100101001000000101001
00000011000000000000000000001000000010011100000010000001000001100000000000000000000000100000101000110
00000000001000100000000000000010010000000100000000010001100000001000000001001001000010100010001000000
00000010000000000000010000001100000001000100010000000000010000000000000000000000000100000000000000010
10000000100001000100000001000000100000110010000001000011000000101000000100000010000000000000010000000
00100100101000011000001010101000001100000000000000000101100000000000100000000100100000010000000001000
00000011011000010000001000100000100000010010101001101000000000000000000001000000001010000000000000001
10000000010000000000000000001000000100000100101100000010000000001011010010000111000001000000000000000
10111000001000000100010000000000000000010100000000001101000100011100100000000101000000000001000000010
00000010000000001001010110000000000000100000100000000010100001110011010000100000000000000010010000000
00011000010101000100000010000010000000000000010001000000000000000010010000100000000001100100000110000
00010000000000000001000000000000000100000100011001100000000000100010100010110000000010110000000100000
00100100100000000100010100000011001000000000001000000110000000000000000001000000001111000110000000001
00000000011001000010000001000000000000000000000000010000101100000001001001001001000000010000001001000
10000000000000001000010000000010010000000000000100110010000000000010000001000000001011010100000000000
00010000000000000000001100000000000110001000000100000100000001000000000000010000101000000000100000010
00001100001000000000100000110000000100101111001110000000101001000101001010011000000000000000000001010
01000010010010000100001001000000000000000000001000001001010000000000000001000001000000000000100100010
00100011000000001000100001100010000000000001100000000000000000001010000001100000010001000100000000000
00001000000100000101000101000100001000001110001000000000000000000000001010100000000100000000010010001
11000110101000000110101000100010100001000000010000001000011000000100101000001000110000010000001000110
00000000010000000000000101100000000000001000101000000001100000001000000000000010000000001000001000000
00000100001001000100101000010100000000001100000000000000000010000000000000100000000000000101000000100
00100000000000000000000000000000001000101011010001000000000000001000110101000010000010000000000000100
01000000000100010100000001011000000000000110000000001000000100011000000000000000100000001000001000011
10001000011001010000000100100001000000110000100000010010000000001100000000000000000001000001111000100
00001001000001010000001000001001000000000000001101000000000000000011000000000000111000000000000000001
00010000000001001101010000001000000010000010000000000000001000001000000000000010000010000001010110010
00000000000001000000010010000100100000000000000100000001000011000001001000000000010000000000000000000
00100001000000000000000000010000000001010011000000001010100000010000001000000100000000000001001000000
00000000001000000000000000010000000000000000000000010000000100001010001000000000000000000100000001100
10001001100000000010000000000001001000000011100000000000000100010000101010000000000000000010100000000
00001000010110010000110000010000000000000100101000000010001000000000000000001001000000000100011010010
00010001000000000000010000000000010110000000000000100100100100100001001000010000000100000000010000100
10100000000000001000001010000010001000010011000100000001111011000010000000010000000000000010101110101
00000000000110000010000000110011000000000001000000010001001100000010000010000000000000000000100000000
00010101000010000000001001000010100011110000000000000000000100011000000010000000010010000000000000000
00001000100000101000100000000000000000001000000000000000000000000010000000011101001000010000000000000
00001110100101000000000100000001000100000000010000000000000000000001001000100001000011001000000000001
00000000000000100101000000000100100000110001000000000100000000000010100000100110101001000000000001000
00001000111100010000010101000100000000000000000001000010011000101010000001000000110000000000001000001
00001000000100100001011000000100001000000001100000000001001001000000000010000101011010010000000000100
00000000001100000000000100000010001101100000000100000001000010100001000000010101000001001000000001011
10000000010001000001000000000000000011010000000000001000000110000010001001000000000000100001000000000
00000010000000010101000100000001000000000001101000100000001000001010000010010000010000101000010101010
00110010000010000000000000000000001001000100000000000000000000001001000000000000001001000000000010100
01000100010000001000000001000000100100110000000000010000000001000001010001100000000100010000000100000
00000000000000000000010000100001000001000000001000000000101000001000001010000100100000000001001100010
10000000000000001010100000000000000000000000000000010011100010000011001000001000000110000010001100000
00000000100000000100101000000000000011000001010011100000000000100000010100000000000000000100000001001
00000001100100000000000000010000000010001000010010000000000001000000000101011010001001000000000000000
00001000010000000000000100000000000000000010001000100000000000110000000100000000000000001001000000000
11011001000100010110000000110000010010100000010000010010111000000000000110010000000000000100000000010
10011000000000000000000000000000000000000000101101111000000101000000000000110000100000000000001000000
10010000000000000110000000010100000000000011001000000000000100000000001000000000110011001000010010010
00010000000100001000100011100000010000100100000010000010000001000100000001000000000100000000000000000
00110000001010111000110000000000000010001010010100000000000000010000100100000000000001001010001011000
00000010010101100000000100001000010000000010100100000001000100000000100000000000000000000010110011000
00000000010000001110000000000001000100100000010001010000010000000000000101000000010000101010000000000
10011010010000010101000010010001000001000000001100110000001000010000100000001001000100000000000100001
10001010100000101000000000000010000000000100011000100010000000000000000010000000010000001001000100010
01100000001010000000001000000000000000010100000000100000010000000001010001000000001000000001001000010
00000000010100001000011001000000000001000000100001000000000000000000100000000000100000011000000000000
00000000001000000100001010010000010000000001000001010000001010001010000000000000000010100110001000100
00000001000000110000000000000101000010010010000000100000000000110000001000000001000011100111000010000
00000000000100000000100100000000000110000000000000000000000011011001000000000111000000011100010000001
00000000000100000000000000000000100010001011000000000111000000010000000000001000000000111101000000000
01000100000001010100000011000100010000000000000000000010000000000000000100010100000000011000100000000
01000000000100101000100010000010000010000100000000000011000000001000100000000000000000000000010000011
01000001001010011001000000100000001000011000100101000001000011000100010000000011110000000110001000100
10010001000000000000000101000000011000000000000100011000011101000000001001000000011001100100000000010
10010000000001001000000000100000100000001001011100010100000000001000001011000000000000000010000000010
00000000100100000001000010100000100100000000110001000000011000100100000101000010000001100000010010001
00001001000000000000000000000001100000010100000000100010010000010000000000100000000000010000100101010
10000101011000000010000010000000100000000101000100000010100010100000000000000010001101001100000000100
00000010010010010100000000000001000000010101000000000010100000000010001000000010000010000000000010000
00100000101010001000000010001000000010000000100010000000010010000000000000000001000010010000000000101
00000000010000000000000000000000001001001000000000000100000000010001000000000000000000001000100000000
00000001000001000100000000000110000100001000010011100000010110001000100000010000000000000000001000010
00010000000000000000000000000000100001100000001100000000000000110010000000000000000000000000000100100
00100000011000000001100001001000000010011000000000000001010000000000000000001000001000000100000001001
00001000000000000000000000000000010001001010010001000110000000000000000000000100001000100000100000100
00110101001010010010000000000100100000000000001000000000000010101010110010000000000000000010010010000
01000100001010101000100100000000000000001001000010100010000000100101000001000001000100001000001000100
00010010000001010000000000000000100001000100100010100000000010000010010010000101010001000001000000000
00000010001100000001001010010010001000001110000100000110000000100110010000000000001010100000110110110
