00000100000000000001000000001100010001010000001000010001000001100010110000000000100000010000001000000
01000010100100010110001000000100000000000000000010100010001000000000000000100000000011000000000001000
01001010000000000000000100010010000000000000000000001100100111000100000000000000001000000000000010000
00011001001000000011000000000000101010000000000000001000010010100100000000100000100010000000100010000
00000000000101000000000100000001010000000000001000100000000000000001001001000011000000100110001000100
00000000000000000000000101000010001011001000000100000100000000100000000011000100000010000000011010000
00000001000100000000000010000001000110010000000000001000000010001000100011010000110100010000010000000
00011100010100000000100010000010010000000010010111000000000000011001000000000000000000000000000100000
00001000000100000000100111000011010100000000100000000000100000001000000110000000000000010000000100000
00100001000000010000010001110100001010000010101000000100000100000000000000010001000000100000001000100
00000100000001000010000000010000100000000100000010000000000001101001010000010010010000000000010000001
00000001001100001000010010010110101000001000011011000100000000100011000000100100000100010000011001000
00010001010010001110000110100000100110000000110000000000000000001100000000000010000000001000000001100
00001001010000000101010101000000000000100000000000000001001000000010000000010110010001010000011010001
10000000000000000000000001000100000000000110100001110000000001000000100000000000000010000010000010100
00000110010000000000000000000000000000000000000010000010100000011001000000000000100000000110010000100
00010000110011000100010000001000100000001010000000000000010000000110100001000000000000001000100000001
00000010000001000001000000000000000000000011010000000000000110000010000000001010000000000000001011101
01001000000000000100010000000000001011001000000000000000000000110000100000010100000001000000100000010
00001000000000010000001000000100000000000000001010000000100000000000000010000000000000000000000000000
00010000000010000010000100000000010000100101000001001001000000000000000000000100001000000000010100000
00001100011010000000000100100000000000100010001000010000100100001000001000100000000000000000000000010
00100001000000000000000110000001000000000001000000000110100001000100101010000100000000110110000001001
10000010000101010000000010000001101000001101000000000001100000110100010000000100000000000000000000100
10010000000010001100000000110000000000001000000000000000000010010010010011100100101000000010000000000
00000000010101000000000000000000000100010110000000011100000000010000010001100010000100001001100001000
00000000101000100000000100000001100000100100100100000000000000000000000001000000100000000001010010001
00000000000000000000100100000100000001000000000000110000000000101000000001100000010100001001000000000
01000100000000100001000000000001000001000010000000100000100000100000000000001000101000000000000000000
00110000000100000000001000000000101000000000101000000000100001110001100000000000110011100000110000001
00000001000000000100000100000000000010000000000001001000101001100010010000000000010100010011010000001
01000100000000001111000100000000011000000100001000100000000011101001000010010000000000000000000001100
10100001101000000010000000010000000010000001000010000000001001001000000110000000000000000001101000001
01000100000100000000101000001010000000000000000100000000100100000011010000000001100001100000011101001
00000011000001000000100001000100000100000001000011000100000000101000010100010000011100000000100001000
10001000000000000000000000001100000001101010100110011010010100010001100100000100011001000000010001000
00001000010100000001100000001100010000101001000000001100000000001110110000000000000001001000000000010
00100000100000001000001000100100001001000100010000000000000100000110110000000000000000010000000000000
01010000000010000000000010000100000000100001001001001001001000100000100000100010000001000000000010000
00000010001010001001010001000000000000001000100000011100001000000001000000000100000000000011100000010
01000001000000100000000001001100000000010100100000000000000100000000000000001100000000011000000100000
10010000000000000001000010000010110000000000000000100100000001010010000000000000000001000000000000000
00100100000100010000000000100110000101000000000000001000010100010000001100000000000010010000110100000
00001000001011010001000000000001010000001101010000010000000000100000000010000000011101000000101100100
11000001000100010000110101110000010010000001000000000000010010000000101000100000000000100100000001100
00010100010000100011000001000100011000000000000100100001000011001010010010000100010000000000100000100
10000000000010000010110010010000000000000000000000010010011100000000110001010000101010010000000000000
01100000001001000000010000000000000010010001100000000000010110001001000000100001000000000001000010000
01000000010000000000000000000100010000000000000010000000000000000011100000110100100100000000000100000
00000000010000000000010100000001000000000010000101001000010010000011010001001000100010010000000101010
00001010000000000100010001000001001001000100000000000010001001110000000000000001000000000010000001000
10010000000000000000000000000000000000000001000100000000001010010100000001010000000001001001000000010
10000010000000000000000000000000100000001010000000000000000010100000010000100010100011100100000000000
00000000000001010000100000101000000000000000000000000000100000000000010000100000000100000100000000000
10001010000001000000000000000000100100001000010000000000000000000100001000000000000010100000000000100
00000000000000000110000000000100000000000010000001000000000011000010000000111000110100000000100010110
10000000100100010000001010010110000100000000001110000010000011000100110000110000000000010000000000000
01000010000000000000100000011010000100000000100000000000000000000011000000000001101100010000000000010
00000000000010000000000010010000010000000110000001100001000000000001100000000000100000000011000110101
00010000100000000000011000001100110001001011000000000000000000110110001000010000001100001100001000010
00010000000000001100000000000101000000000101101010010010100100000101010000011010000101000000001000000
01000001010110000010000010111011010001000110000000000000000010000010001000100001000000100000010000000
01000000001111000000000100000000000010000001000000001010000000000011000000001000000010101110000100000
01000010000000000000000000100010000001110000000010000000000001000010010100100110010000000000000000000
00000100010000010100000000000000000000000100000000000010010101011000000000001110000000010100000000110
01000000110000000001000011000001000000000000000000000000000000000110000000000010000000000000101010000
01000010110000000001010000000010000000010000000000000001000000000000001010100001000010000011000010000
01010000000010000100010000000100100010000000011001100001001001001000100000101100001000001000000001000
00100000011010000000100100000010000000000000000010100000000000000000010000000001110000001100000000000
10100100100000010000101110000000010001100000100000010000000000001001001111000110100000000110101000000
01000000010000100101000000000000000001000000100000000000001000000010101100000100000000010010001010010
00000000000000011000100010000110000000011000000000011001101100011000100000000000000001010010001000000
10100000100000000000000110000000011010000000100001101010100000100000100000001100010000101100000100000
01000000000100010100010110000001000001001000001000001000011000000001000000000011101100000000110000011
10010000000101000100010010000000010010000010001100001000000011110000000100000000000010010000000010001
00000000001000000000001100010000000001010100001100010000000010010000000000011011100001000000100001100
00000100110000000010000110000000000000000001010000001000000000010001001000000100001000100000000000000
00100101001010011010000000000001101000000000000000011000010000000000101000000000000000010000100100100
00010000000100000000000000000000000101000100100000100000011010100000100000000000100100000000000110110
10000100000010000000010110000100100001100001000010100000000000011100010001001000000000000100000010100
10000101000010000000000000010000001010000000100000000011010000100000000000100000000000000000001000011
00100000000010010000000000000001000000011000000101000011000000000000000000000001000000010010010001000
00011011110000011000010000100000000000000000100011010100000000000000111001000000000000000000100010000
11000000000001010000000000100101001010000101001010011100010100100010000001000100000000010000000000001
00110011010000000001000000000001001010010000000100001010100110100000000000000000101000000000000000010
00100110011001010000001000001011010000000000000000000000000000000000000010101000010100100100000000010
00000000001011000101000000000000000010010000110100010000010000000000000010010000101011000010110010000
00000100000011000000010000000010000100000000100000000000100000000000001000000000000000100000000000000
00000001100000000000010010000001010000010001000001000000001000100100010000000000010100000000100000010
10001100000000000001000110000000000100000000101000000100000000010000000011100000111000110001000010001
10001000010111000011000010000000000000010000000010100000000000110000000100011000010000000000101010010
10000000100000100000000010001100001100010101100000000000000011000000000000100010000100001000000000101
00000000000001000000000000001000100010100010000010000000000010011001000000010000000000001000100100001
01000000000000100100011100000010000010010000010010001100000001000000000010100000011001000000001001001
01010000000000001010000000001000100011100000100000000000000000101000011000000000011001000000000011110
00000000001000000000000000001000001001000100000000000000010001000100000100001000000010100100000100010
01000011000000001000110000010000100001000101000010001001000000000010110101000000100000000110000010010
00001000010001000000000110100000001000000100001000000000000000000011000000000000000000110000010000000
00000010011000001000000000000000000000000000000000010000000010000000101000000000000000000000000000000
11000000000000001010000000000000000101100000010000001010010000000000011000000000000000000001010000000
00011000010000000001000000000000000000000000000000000000010000000000011101011010001110000010001000000
