00000000000000000000000000001000001010110000000001000010001000000001001000000000000000000000100100100
10000000010100000000010000010010000100001000010000101000100000000010010000011000001010001000000000001
00010000010100000100000000000000001000100000000001101100100000000010000100000100000100000001011110110
00000000000000001000100010001000001000010000100010000000001001000100000000000000000000000000000000001
00000010100010000000011000100101101010000000001001000000001010000100001010000000000000100000000000010
10100000000110000011000100000001000000000000000000000000000000001000010000000100011011010100000000100
00100000110000000100100110000001000010000000110000100001011001000101000000100000000011010000000000001
01000000000010001000000000000010000001010000000011000000000000000000010001110000000000010000000000000
00000000000000000110100010000000000010000000100000000010011001001000100001000000000000100000000101010
10001000001000000000010001110001000000100100000000000000000111000000001000010000000000000101011000010
01000001001000001000101000000000110010000001010000000000000000010000000000010000001000000000000000000
00000000000000010000101000000100100000010000000010000100000000000000010000000010000000000001010000101
00000001000001011000000100000000000000000001000000010110000000001001000000100101000101010011000000100
10000000000010010000010000100100000000000000000100000000110100010100000000000000110001000000101000000
10100000010000100010101000000000100010000000011110000001000000000000010010010000000011010110100100000
00001000000000010101010011000010010100000010000001000000001000001000000000000001000100000000000001010
00101011011101000000000000000010110000011000001000000100000000000000101000001010100100000010000000000
00000101000010010011100100000100000001000010010000001010100000001000100000000000001000000001000000000
00100001110000100000000101100000000001000010000000000000100011010001000010001000000000100000000000000
01010010001000010000011000000000000000000101000100000000000000000000001001100000001110000000000110000
00010000100010000000000100000000001000100000010000010000000010000110010000000000000000100001000000001
00000100111110001000010011001000000100101010000000000000000000001010000100001000000000000000100000001
10000000000010000000100000000100010000010000000000100000100001100000100010000000110000000001001000000
01010000000001000000000000000001001100101000000111000100001000000000000011001000010001000000010000001
00100010000101100000000000000011000000000000000000000000000000010000010001101000001100010000000100000
01000000100000000010000000000000000000010101000000010100010000010100000000000100000001100001000000000
11101000110010000010010000000001000010000000000100000110000001000100000000001100100000000001000000000
00010000001000000010000001100000000010100101000000000000000000000110010010001101001000100000000000010
11010000000000000100000000100010000100001010010000000000000000000100010100001010000001100000000000010
10100010010001000000000010010100000100000100000000001000000100001100100000000000010100000000100000000
01000010000000000001001010100000000000000000000001001010100010101100000100000000100000001100011001100
10100000101010000010000010000000000000000000100100000010010000000000100100011100110001000100000000000
00100000000000010000000000000000100101000100000001100000100010101010110010110011100000000001100001000
01000001101000000110000000001000010111000000101100000000001001000001000010100000000100000000100101000
10010000101000000000000001000000000010000000000000100000000000110001000000000010010010000100000000000
00000101000000000000000001000000000100001000001001000000100011000101010000000001101010001000000000000
00000101010010010000100010100000001000100000101000000000100000000001010000000000000010100000001100000
00000000010100001100000100000001000100000000100000000001100010100011000100100000000000011010000000000
00000000000001100000100000000000000010101000000000000000000000000000100010000000000000001000000000000
00000010000100101010000000100000001000000100100100010001000000000010010000000110000000101000000010010
01100011000100000000000000000101010011000010000110000000010001000010000001100000010000100000100010000
00010000000101001000111001000000000000001100000000000010000100001000000000001001000010000000100000000
00001001000000000010001000110100001000000000000100000000000000000010010000000000000010000000000100000
00000000000001100001000000000011001010011010001000001000101011001100000001000000001001000000000000010
00100000000000001000110100000001000000100000100000000000000000100000000000110000000000000000010100000
00000010010001110001000000000000000010000000000000000110101000010000010000000000000000010000100100100
00000001000100001000000000000010000000000000001000100101001100100000100100000100100000001000100000001
00001000000000011100000100101101100000011000000000110011101110000110000001100000001000000100000000001
10000100010000000000000000000000100000000000100000000001101000000000100010000010001000000001000011100
00011010000001100000010000011101000000000001000000001000000100000000001000000000000111001000001000001
00000000000000000000000000000000000110100000000000100000000000110000000101001011000000100100010000000
10000100001000000000010100101010000000001001100001000000001000000010010000000000000000010000000000010
00011000000100000000010110001001000000010000000100000100000001010000000000111011000010100010010000001
00000000000000001000010100000000110000000100000000000000000000000000110100001000100101000001100000000
11000010001001100000000000001001001000110000010000000101000001000000111000110000010101000000110100000
11001000010101001010000000100000000000000110000100100100000000000000000000000110100000100000000100000
00000000000000000000000011000000000100010000001000000000010000000010100001000100000000100010010001000
00010000000011000100100000000000000010000000001000000110000100000000100100000000010110000010000001000
00100000010100000000000000000010000000010000000011110000010000010000000001000010001100010000100000000
01011101001001100101100010000000110010000100100000000000100001000000000000010000001010000000000001100
01000000001111001100000100000000000000010100000000011000100100100101000000000010000000010000100000000
00000010000000000100000100000001000000000000000000000000000000000101000000000000000010100000001010000
00010001000100000000000100001000000001000100000000000000000000100001000010001100000000000000000000001
00000000000000000000000010000000000000000000010100000100001000000000000000000001000000000000000000000
00001000010011000000100001000000000000010000000001100010100000001001100100100100101000000001000000100
01000000111010000001000000000000000010000000000010000011000100010000000010000101000001000010000000000
00110000100000001100100000000000101000101000000010110001010000000000000000010101000001000001100010000
01100010100010011100000011000000000000010001000101100011000010000001001010000000010000010000000100001
00000100000000000010000001000000001000110100000000100000000111011100000100000000000000000100100100000
00001000110000000010000100100000000001110101000000101010110010101000000000000000000110010100000000100
00000000000000000110000000010100000000101001000000000000001110010000000000000000001001000000000000100
10000100000000000000000000001000000000000100010000000100000000000000010000000011000100000001100001100
00000000000100000000010000000010011010000000000010000000000100000010001000100000000000000000000010000
00100000000000010000000100010010000000000000100000100010000000000010100001100000000000000011000000000
00100000100001000000111101000000110000010100010001000100000001011100101100000000000001000100000001100
00100110000000010001110000000000100000100000000110000001000000010000010100000000000110000000000100000
00010000010000000000011000010000001000100000000101000000100100000110000001100001000000101000000101000
00100000001000000000010111000000100000100001100000000000000000000010010001110010010001100100000000000
00000000000000100000100000010101000010000010000110000100010000100110000000010101000000000000001000001
00000100001000010000010011000100000101100100000001001000001000000000001000000000000000101000001001101
00001000010000010100100011000010000011000000000000000100010001000000000000010000000100000010001000000
01010001001000000001010000001000100000000000100100000010100000110001000000000101100000000000010001110
01000000000000000100000000100000000001000000010000000000000000001001100010001100000000100000000000000
10000001010000000000010000000000101100010001000100000000001100000100000001000000110001000010100000000
00001001000001111000000010000001000010000010100000000000000001000110001001000001111000000001011000000
00010000000000000000110000000000010110100000001001000000001000011000010000000000001000000011000000001
11010001000110000001000000000001000000000000000000000000001010000100000100010000000000001100000000010
00100010000010001110001000000000100001000000000000100000000000010001000000100100000100000000110000111
00100010000000000010010000010000110010100000000000000100100000001000000000100010000010001010000000000
00000000010111000110000100111100010000000010000100000010000000010000000001000000000101000000000000000
00000000011001000000101000001000010001111010000000000010000000010000000000011100000000010010001000000
00000000000100000000010010000000000001001100001000011000000001000011000010001010000010000000010000000
01000000010000011000000000000100010010010001000001001000000010000000000000100000000010000000000000001
00000000011100000100011100000000111101000000000000000000001100001010000001100001000001100000010000110
00010110001000100000001010100000001001010000010000001000000000001100000001011001010000000000010000000
00000010000010000100001001001000001000000000000000000000000101000000010000101000000000010000000100000
00000000000111000001000011000000000000010000000000000000000000001000000000000010000000001000010000001
00000010001000010000010100000010100000110000000000100010000000001001000010001000000010000000101100000
00000000001010100011000010001000100010000010010000000000000001000000000010000000000000000000001000001
00000000000001100000100000000000000000000100011000010101100000000010000000000010000000010000010000000
00001110000000010000000000000000010010000000001000000100000000010000000101000000001000001000000100100
