01000000000000011001000011000000000000001000010000000010000000000010000000000000000000000001010110000
00000000000001000000010000100100010000000000100000100000000100000000001000000000001000000001000001000
10000101000010000000000000000001011100000011000000000000001000000000000010001010001000000000001000000
00000001000010001010000011000000000000001010000001000000000000000101000100000000010110100001000010000
00000000000000100100000000000001000000001000000001000000100100010000010100000000100000010000101000100
00100101110010000010010000100000010110000001001011000000000100110010010001000000001100000100000100100
00000000000000000000100100110000000001001000101110000000010000001010000001000011001000000000000000000
01010000100011000000000000010000000000010100001001001010101000010000000000010010000110000001100000001
00100000000010000011100010000100000000101000100100000000000000000100100101010000010101100100001100000
00000001100000010100100000110010000000001010100000000010000000000010000010001000010000011001000001000
00000000000000000100000100000001010000000000100000100101000100010100000010000000000100000000000000000
00101000010000001101000010000000101010010110001000000010000100000000000011010001100110001000100000000
01001101000000000001001110101010001000000110000100100010100101000000000000000000000000000010000110001
00100010010010000000100010110011000010001000000000000001000000010000000100001010010100001001000010000
00000000000010010011100000000001001100010001000000000000000000010000000000000000000001101100000000000
11000000000001000100000000000101010010001000000000100000000110000000100000100010001110000000000010000
00000001010010000000000001000000010000000101011000011000010000001000100000101000000001100100000000000
00000001000000100010000011000000100000110100000000000000000000001000010001010000000001000000000000011
00000100000001010010000000100000000000000010110000001000010000000100000100001010001000010000000000000
00100010000001000000000000000000011110011100000001010010000000000000001001000000000110100010001000010
00000001000000001000011100000010000000100010000000001010001000101000000000001000010010001000000011010
10000010010011000000000001001110000000000000000111101001010000000001000000000100000101000000001000000
10100001011000000000000110101010001000010000000000001010001000000000000100100000100000100000100001100
00000000100001000000000000001101010000010000000000000000000100000000100010000100001110001110000001000
00010000001001000011110000000000000100010001010110000000000011000001001000000000000100010000000101001
00010100000010000000000000010000001000100010000000100000000000000000010000000010000011100001100000110
00110000011000000010000000110000000000000001001000111001000000000000100100001010000000000000001000000
10010010010100000110000100100001001000000110000000011001101001010110001100000010000100100000001010001
00000010000001000000001110100000000100010000001100001000001100100000000011010000100000001000000000010
00000100000000000000000000000000100010000000000000001000100100000000100100110000000100110110000100000
00000000101000000000001101110000000110010010000000000010110000000101000000010000101000110011100000000
00010000000010100100000000000101000000010000000001100100001100000000011110011000000001001000100101000
00000101000000000011000010000100110010100000000000000000000000010000000010100010001000001000010100000
01101000000011000000010000001000001000010000000010011001000000000000000001000000011010101000000101001
00000001011110010001000000000000010000100100000100000000110000000000001000000011000000000010010001001
00000000000000001100000001000000000100000010000000100010101010100100000001100000010001000000110000000
00000001000100100000000011010000000001000010000001100100010110000000000000000011001000001000000010000
00010000000100000010100000011000000000000000000101100000100000011001000110000011001010001000010000010
01000000100000000000000000000001101000000010001000000010010001000000000010010010100000000001000000000
00000100100000100000000010000100001001100011000100100000010100000001000010110000010000000000000100000
10001011000000100000000000100000010001100001000000000010001011000000000100000001010000000000001000100
01000010000010000000000000001000000100100000000000000000000000000010001100000000000000100101000000000
00000000100110000010000000000010000000000001000010001101000000100001001000000010100010000000000000000
01000000000010000100000000000000000000100100010000010000001010000000100000010010001000100010000001000
10001001000000001000000000000000110100001000001000100000010000010000111111001101000000000000000000010
00001000000001000000100000000000000110010100000101000001000000000000101010010000100001010000101111000
00010000000010000010000000001000001001011001000001000100000000000000001010100100010100010110000010000
00011000000000010001000100010000001101100100001010110000100010100100000000100100001000000010000000000
00000001000010101010000000000001001000011001000000011000000111001001100100100000011000000100010001000
10001000001000001110000001000101101000100010000000100101001000110110000000000010100000000010000000000
00010000000100000000100000011100000110001000000000000000000001000001000000000000000001010011000010010
00010100000100011000100000101000000000000100000000100010001000001100010001010100001010100100100000000
00100001101000000001101100000000000100000100000100010000000010010000000000010000000000100000000010100
01000101000000100100000010000100000001100000001000010000101000000100011000010010010000000000000000100
00110010000000000001000000000000110000000000000000000000100000100000000100000000001000000001000100001
00000100000100000001000000000000000000000000000000100001100010011000100000001010001000000000000110010
00010001100000000011001000001000010000010010000000000010010000000000100000101000000010000010010000000
00000000100000000100000010000001000000000100010000000100000000000000000000000010100100100000100000000
00000000010101110000001000000000000000000100000001001000101000001001010000100100000000000000000000000
11000100000000000100000000000010000000000000010000100010101000000000000001110100000000000000001101100
00000010010000000100011101100000000000000000000000000011000000000011000110100000000100100101000000100
01100000000101100100000010100000000000110000001100000100000000000001000001110000000000000000000000010
01000110000001001000000010000000100000000101000001100000000000000000000000010100000000000000010000011
01000001000000101000000000000000000000000100111000000100100000010000000101000000000000001010010000010
01000000001010000000000000000000000000100100000001000000100000000000000000000010010000001101010001110
00000000010000000000100000000000000001100000001100001000001000000000000100001110101000000001010010000
00000000001010010000100000000000110001000100000000000000000000101000000001100100001000100000001000001
00000000000000000000100000101110000000001000000010010000001000000001000000100000101000000000000000000
10000000000100000000000000001100000000101101000001000010110001101100000010100000010000010000000000001
01000110000010000010100000100100000011010000100000000100000000101000010100010000100010000001001010000
00000000000000110000010000010000000000000010000101011001000100000000000100000000001000000000010000101
01100000100100100010010000000000000000000101000100000001000000100000100000010000000000010000000000000
11101000100001010010000000001100000001000000001000000000100000100000001000010101000010000000000000010
01101000100101110010000000000000100000000000000000010001010000100100000000000010100000100001000000000
00100000000010000001100000000000100000001000001000000110000000000010000000000010000010001100011010000
01000001000000101100010000011101010010010001000000000000000000000001000001010001000000100001000100001
00000100000101000000000000000001000010000100000000010100001000110000010000001000000100000010010110010
10100000001101000011000100000000100001000000010000010001100000000100100000000000100111001001010010000
01100010000000000010000000010011000000100000000001000001000001000001000000100000000000100000000011011
01000100000000110101000000000010000000001000010100000111100000100110011000000001000100000000000100100
10010001000001000000010001100000000011001010000000000000000001000100100010100000000001000000000010001
00001000100010000000000100000000001000100000001100000000100000001001001100000000001000000001100001000
00001000000000000000000001000001100000100000010000100010000000001010001100010000000000000000000000000
10011010000000000100000001010000000000010000000000000001100010110000000000100000100000000000010000000
00000000000100000000001100000100000001110000000010000000000010010000000110000001101000010000010011100
00010100000001000000000000000000001000101000000000000000010000000010000000001000100100011000000010010
01010000000001011000100000100000100100000000000010101110000010100000010010000000010000000000101000010
00010011001010001000000000101000001011000000000000000101100000100000010010000100001000000000000000001
00011111100010111000000000000100100000000000000000000010010001001000000000000000000000000100000000000
01000000000000010000000100000000100001000001110000000001000001000000011000000001000000010000000010001
10000000000000110000001000000010100100010000110100000001000001001000000010000000101000001011000100000
00000000010001000000000000000100000010000001000100000001000000010000000000000100000000000010010000100
00000000001000010010000000000011001001000000010111100011001010010000000000100000100100000000100010000
00001001000000000000100000100000110000010000010010000000000100001000000000010110100010010000000001010
00100000000000000000000111001000101000000000111000110000000001000110000001001000000001001111000100000
00000000001001100000000000000000001010010000000001000000000000000000000100001000110000110100001000000
10000000100100000000000000110000010100010100010100000000000000000000000000000000000100000100100100100
00100100011000011000010010001000010100000000100110000000000000101100000100010000000100000000000000000
00000000010000000100000000010001010010110000001110110000000000000000000010000110100110000100010100010
01000001001000100100000010001000000100010000000001000001010000000100000000100000000000000000100001000
00100000000000101100010000000000001001010001000001000100000110000000000100000000100000000100001000000
