00010100000010100000000010011000000000010011010000000000000100000001001000000100000000000110000010000
10100000010001000100100010000100000000010000000010000000000000100000000000000000000110011000000001000
00100010001000000001000000000000000010000011000000000000000110000000000110000100000000110100001000001
00001000010000000000001000010000000110110000110001000000000000001000000000000001000000000100000000000
00000011000001000000000000000101100000000010010000000000000000010000000010010100000000000001000011011
00010010001000110011000111100000000000001010010001100000000000011110010010000000000000000100001010000
01000101001010000000000100010000000000000100000000000011000100101110000000011100100000000010100100000
00000000010010011000101010010001100000100001001001000100000001000000000001100000000010000000110001100
01000010011000001000000011000001000010010000000011010000100000010001000100001000000000101001010001001
00001010000000000001000101001000001000011000000001100000001000100000100000100000000100000000000000000
00001110000100010000100000000001010000000000000000000100110000100000010101000000000001000000100010000
00000100100000100010100000000000110110100001000000000010000000001000000000000000000000100110001000010
00010010000001010000000000010000001110101000000010001010001100010000001000000101000010010000000000000
01100000100000001001000111000000000100000011000000000000000000000001001000100010100011000010000100000
00000110000000101000001000000111000010010000000000000010000100000101100000000000010000010000100010000
10010100100000000100010010101000100100000000000001100010001000000000000100100000100000000001000000000
00010011000001001001000000000000001010010000000000110000001100010010000000100100000000001010001000000
01101000000010000000010000100000000000001001010001001000000000000000000001100000010000010000010000001
00000000000101000100100001001000001010000100011001101000000100001100001000000001000010000010000010000
10000010000000000010000100000100000000000000000110101101001001001100000001100000000000000000000000010
00000000000001000011000010001000001100000000000000011000100000000000000001010000000000001100000101000
00000100100010000100001010000000000100100110001000010000001001000000110000000000001000000000001000000
00000000000000000000000100010000010000000010001011000000100000000000100000001001001010000000000001010
00100000100100000100000001000000000000101010000011000000000001100100000001100000000000101000000000000
00000000001001010000000110000111000100000000101101110000010110000000100000010101101000011001000000000
01001010000000100000110000001000001000010001001001000000000000110000000110000000000000001001010000001
10000000110000000010001001110000000000001000000010000000000000000000000000000001000101000000010000000
00000001100000001000101101000000000000000010100000001010000000000100000000001000011010000010000000101
00000000000010000010000000010100000000000000000000000000000010000001000011100000001001000000000110001
00000100100010100000001000000000111000001000001100000000000100000000010101101100000000110000000001001
00000000100100000000000000000100000100000000011000000000000000010000000100000000000000000001101000011
00101000000010010000001000100000100100000010010000001110000010010000100010010001001000100001001000000
00010010101010000011000011000010000000000010001000100000001010000000000110000110000010000000000000000
00000001000101000010010000000111000000000001000001000010000000000100001000000000001001010000000000000
00000100010100000000010101000001001000000010010100110010000000000001110000000101011000011000000010110
01000101110000000010010100001000000001000000000100000110000010000101011000000000010000000000000000100
00111000010001000000000000000011101000000000100001000000000100000101000000000010000000000001001000010
00010001010000000100000010101001010001000110000100100000000001000110000000100000010100000000100000000
11001000000100000100110010001000110110000000000100000000000000101010000000000000101010000100000000000
10001000000000001001010000001111010000000001001110001001000000000001100000011001000010000000000100110
11010000000011100110010001000000000000001000000011001000100010001000010110010000010000001000000100000
10001000000100100011000011100000000001000000010000001000000010000000000000001110001000010000000000000
00000000000000001000010110000000001010110100000000111100000000001001000101011000010000000000001000000
01010000000001000000000110000000000001100000001100100010101010000000000000000000100000001000001000100
01010000111000011000000010101010010001101000000000010010000100000000010101000000110100001000101000000
00000010010011101000101000000110001000000000100000000001100010100000000000011100100000001010000000100
00000000000001010000110101000001110000010100110000001110000000001000100001010000110000000000010000001
00000000000000010000000000001000010000110000000000010010001101000100001010000000000000000000000000000
01001110000010000010001000010000000000110000011001000001000000001001000000000001000100010011000000000
00000000000000000010001010000000000000000010000000000000000000000000011000000100001100100010000000010
01010100000000010000010000100000001000111110010010000000000010000001000000000000000000000000000000100
01110000010000000010000010000000000000100000100000001100000000000000000000100001000101000000001100000
00000000010000000000011010000000000000000110101000001100000010010000000000000000000000001011100000000
00001000010010000000001101000100110001001110010110000011100000000100000000000010000000000001000000000
00110000010000000110010000000000000100000000000010110001000000000000000000010000000000000000000000000
00001001000000000000100000001110010010010101000000011000000001000000000000000010100000000000000000000
00000000010000000001000001100000010100001000100000000000001000000001000000001001100000000000010110001
00010010110000010000000000000010001000000010000001100001000000100010101000001100010011100010001111000
11000011000001000000000000000000010100100000101000000000000000000000100000100100001000001011000000010
00101000000000000000010000010000001000000000010000100000000000010000000000100011000000000000100000000
00000010001000010001000000000000001000010000000101000000000100010000000000001100000000001000110000000
10000000000000000000000010010000000000000000000000011000010000010111000000100000010000001000000000000
00000011100010000000000000000000000000000101011000101001000000000000000010001000000000010010001010000
01000000010000000000010001110000000001000000000100000000000000000010010000000000000000101000000010000
00000000110000011000000100000000000000000000011010000001001000000000000101001010010000010000010000000
00000000000000000001011000000100010100000000000000000111101011001000010000001000000000000000011010000
00000001010000101000000100000000010001000000000000001000000000000000000000001000001000100010010100010
00100101000000000100000000000010000011010010000000000000001000000001000100001000000000000000100000100
00100001000101000000001000000000100000000010001010000110010000000010000000001000010010010001000000000
10000000000000000000001000001000101000001010000100011000000011010000000010000001000000000100010000000
01100000000001000001000100000000000001000001001100001001000000001010000000010100000101001100100000000
00000001000000011000000000001000100101110001001000000000000000100000010001000100010000000010000100000
00000001000011000000100000110100000010010000000100100100001100000000100000001000001001000011000100000
10000000100001100000000110001010000000000010100100000010000010000010000101010000000010010101000000110
00000001000001000001100000000001111000110000000100000001000000000010000011001100100101001110100011001
00000000000011000110001001001000001011000000000000000100000000000000001000000001100000000000000010100
10000000000000100000000000000000100000101100010101000000100001100100110000000000000000000000000010001
11101010001000000000110100001010000010001000001000110101100100000000000000000100101010001101000100000
00000100000000001001000000000100001000000000110100001000001010000000000010000001000000110100000001000
00010000100000001000000000000001010000000000010010000000010000001001100010000000000001110000000100001
00000000010010101000000000001001100000000000000000100000000000000101000100001000001000000010000010010
10000000001000010100000000000000000001000100100000000001010000001101101110010000000100001001000100000
00010010100000000110000000001010001100000010000000010000000000010100101001000000000000000000000001100
00000110000000000100001000101000000100000000000000000100011100001110001101000100001000000000000110010
00000000100000100000000000000001000100000000000100100011000010000000100000101000001000000110000000010
00000000100000010000010000000000000100100011000010000110000000000000100000000100010100001100000000100
00000000000001010100000001010000000000001101000000000000000000100001000001000001000001000000000000001
00100000100100010000001000010001000000000000000000011000000000010000100000000000000010010000000000000
00000000000000000000000000100000000001000010000011000001000000000000100001110000000000000000100000001
00001011011000000110100001010011000000100001001010000000100100000000011000000000000000000100010000000
00010100000000100100000100000000110000110010100000100001001001000000000000000000100010001010010000000
00000000000000000000000001000000000000010000000000010011100010000001010000000010000000001000001000001
10010010000000010000010000110000000000000011000100001000000100000001000001000000000010001000010000001
00000001010000000001000000100000000010100000000000110000000000000010000000011000000010000000000001010
00110000100001000000001010000000010000100100000100000000000001010001000000000000000000000000101000001
00000100010100100000010010000000010100000010001000000000000000010000000001000001000010000000010010100
00011000001100101001101010000000000000100010000000000000000000010001101000000000011000000000000001000
01000101011000000010000000000001000100100010000000011000000100001000010000011000001100000000100011000
01010001000001000000110000010000100000000100100000001000001001000000000000001001011000001100100100000
01100000010000010100001000010100101000100001000001001000000000100000101011110010000000000000000001100
10100100001001010000000000000000111000000000010000000010010000000100001000000000001000000000000000000
