00001000000011010100000001010001000000010100001000001000010100010000011000000001000000100001010000101
00001001000000000000000000000000000000000000010000101000100000100000000000000000000010000001111000010
10010000000010000000100000000001001000010000000110000000010000000000000000010100100000010000001010000
01001000101001100010000001001000010000001100000000000000000001000000010000000100001010000101011000000
11101100000000000101011000000000010100100101000001000000010111000000000000000000010000000000111100000
10000001000000001000100110100001000101100000001010000110010000000010000101000101000000000000010001100
00000010010000000100001000000001010100110000110100100100010011000000100010000011000000000100000010000
00000100100010000000000000000100000000000011010001000100000000000001000000010000000001011110000000000
00001000100010000010000010000000000000000001100011000000101000001000001000000000000000100000001100001
00000000000111001000000000001000010000000010000000000001000000001001001000110100000100010000000000000
00001010010001000000001100010000101000000100000000000100000000000100001000000100100000000000000001000
00100100000000000000000010010001000010000000111010000000000000010000000000001000000000000000100000001
00100101000000000010001001101000000011001000000000000010000000001000000000010000000000000000000000000
00000001000000000100000001001000000000001010000010010100010001000101001100000001000000100100000010010
10000010100100000000101000010010000000111000000101000010001000001000000011000001100000010100000000000
00000000000011100001001000000011000000000000000000000000000000100010000010000000010000000000000000100
01000100010000000000000100010100000001000100010000000101000001010000000000010100100011000000000001011
00000100011010000000010010000000100000101000000000001000001000010001000101000000000000000110010010000
10000001000000000000010001001000110001000011001000000000000001000001100000000000000000101000011010100
00001000000000100100100000001001001000001010000000000000000011000011001011000100000000000000100100000
01000000000000000010000001111000000101000000010000001010000010100000011000010000100000000010001000100
00000000000000000000001010101000010010001000010000000000000000000101000000000000100000000000010110000
00010001000000000011000010010110010001100000000000000000000100100000000000000000000000000000100000010
00001000000000000010000000010010000000100000000000000000000000010000010000000100001001000100000000000
00000010011100100000100011001000010100010000000011001010000000101001010001100000001000000000101010101
00010100000100000000100000001001001000000000001000010011100001000100000000000000110000100100101101001
00000000010100000001010000010100000000110010000000001000000100101000000011000100000000000000000000100
00001000110100100000000000000000000001000010010010100000000000000010000101010000000100010000000000001
00000000001000000100001000000000000011000010000000000000000000010010010000001000100000100010000010101
10000000000000000001010100100001000000001000100100001000100010100000000100001110000000000110000000000
00000000010000001000000000010000000000100000000010000100000110111010000000000100000000000000001100011
11000011000000000000000100000000100100000000000000001010100000100010000010000000100100000100001010000
00000001010000010000100001000000010000000000001011000100100000010011000010000001101110000000000010000
10001010000000001100000000001000000010100000010100000000000000000000100000000010010010100011000000000
11000000100001000000000011110000000000000001000000000100000000000001000101001000000001000001000100010
00000000000010101100000010000010010000001000000000000000000000000000000001011001000011000000000001101
00001000000010001000000100000000000000000100101010010000100000000100000000100000110100000011000001000
01000000000000000000000011100000100000000000000000000100000100000000000001010010100100100000000000000
00000000001000000000001011000000000010000010001101000100101000010000000010001000000000011010000000101
01000100000000010011000000100000000100100000000000000100000000100001000100000110010100000010101000010
00011000001000100000000000000000100100000000000000100000011001001000010000100000101001110000000000000
00000100000100000000100001000000000000000000000100000000000000000101000011000010000000101000000000000
01001000000000110000100001001101000011000000000000010000001100101000000000100100000000000000000110000
10000011100000100001000000000000011001000010000000000000010100000000101110000000000100000000011000001
10000000000010000001010000100000000000000000010000000000000000000010000000000001000100100100001100001
00010001010010010101000000001000000000010000000000000000000000001000000100000100000001000000101100000
00100100000000001011100100100000100010000000000000001000000000101000110000000000000000010000010000001
00100100011000011000000101000010100000001000101000000000000000000000000010000000100010000010010000001
00000011010010000001100000000000001010000000000000100100100000000100010000000101100010100010101000010
11000000000000000100000110100010010011010000000000001000000000000000000000000010000000000010000000000
01001101010000000000100011001001000000100100000000001000000011000001000000010000000011000000100000000
01000111001011000100110000101111000001100000101000000100000100000000000000000000100100000010100000000
10000010000000000000000010000000100010110000000010010000001000000000000010010100011000011000001000000
00100000001000100110000000001100001000000000010000000010100000000000000100000000000000000001000000000
00000111000100010010101001000010000001101000010000000000000101010000000001001100000000111001011100000
10100000100100100000000000000000110000101000100000000101100000000001100000100110001000000000111010010
00100000000000000010000000000001001001001010001000000000000000100100010001001001000000000100001010000
00000000000100100110000011000010000000000101001000000000010010100001000100000000000010000000100000000
00000000001000001000000000000000000000001000000010000010000000010000000000000010000110010000010000100
10000000100010101000110001001001001000100000001000010000000100000000000000010000000100000000000000001
01000010001000000000010000000000000000010001000001110100000010001000010010000100000000000100000100000
00010000000000001100001000000000101101001000000100001000000000000001000000100001101000000010001000000
00000010000010000000001100101101000000000100100000000001001011000000000000010001010000010010010000100
00010000100100000000000100000000000000100100000000000000000000110010000000001100000001000010000001010
00100000000001000110001100000100001000001010000110000000000100000000000100000010010000000000000100000
00000010001100000000000010010000000000000000000110110000010001000001000000000010110001100000100010000
00100100011100000000000010010000000000000000110000010010100000000000001000000000000000000000000000011
01000100001000100101100000000000000000100000101100000010000000101000001000000000001000100000000001110
10001000100001010010001010001000000000000000010000000000000000000000010110000100001000000011000000000
00000000000100001110101010000000100100101000000010100000001000010001000000001000010000100000000000001
00000010000000110010000000011000000010000000000000010001000000001000010010100000000000000010010000000
00000010000010101000001000010000000110100000001001011000000000000010110001000000001000010001110000000
00100000000000000000000111010101000000100000010000101000110010000100100000001001010010010000000000000
00001000000000000000010000000000000001010010001011000000101010000000000000000000010000000000100000000
00000100000101001110000000000010010110000000000000000010100001000010000110000001011000100000000000000
00000000000001100000000000000000000010000000000000000000010010110010101000100000011000000000011000000
00000001100100100000100001000100101000100000000100000010000010000100000000100011000000010100000101000
00010010000000000010010010000100100000000100000000001010000011000101000101010001000000010010000000100
00000000000100000001111000110000010000000001000011000000000000000000000000000010000001000101100100000
00000000000100000010000000000010000000010010110000000100000000101000001000001110000000001000000000000
00000000101000000100001000001100100110100000000000000010011000110100110000010000000101011101100000010
01100100000010000000000000110000100100110000000100000100010000011000000010000000100011001101000000000
00000000001000010010000000010001000000000000000010000111000000000000000101010100000000000000000000010
00010000000000000000000110000001000101000100001010000000000001011000000010101000100000001000000000011
10000000000001000001100010000000001000101011000010010000000000000000001000001000000000000101000000101
10000010001100000010000000000000000110000100000001010100010000010000000010000000000000001011100001000
00100001000000001001000001000010100000001100000000100000000000000011010000100000000000000100000100000
00000000000010110011010000100000010000000001000011000101100010110000000100000100000101100000100000000
00000000100101000011100000010000000001001010000000000010000000001100000001000010000000000000110000010
01100000000101000100000000000000000000000000000100101000101000001010000001100000010100000010010000000
00001000101100001000011110010000000000000101100001001000000010110000000010000000101010000000000000100
01000010100011101000000000000001000000010011001000000000111000100001001011001011000000000010100100001
00010000000000000100010100000100000100010010000101001000001000010010010000010000000001000010010000000
11000001000000000000100100000100100010001010000001001100000111000000001000010010000000000001001000000
00000000000001000000010000010001100000000000000010001011100001100100100000000000001011000000000010101
00000100000000000100001100000010000000001000100000000000000000001000000000010011000000101001100110100
00000000000000100000010000110000000000100000010001000100000000010001100000100001010100000000000000000
00111000000000000001000001000010010011000000010001000100000000000001100001000000010000000000000001000
00000000000010000100000010100100010000000000010000101100000000000000000000000000110010000010011000000
00010110010000001000000000000000000000001100000000000000000001000011000100000000100000000001000000000
00100011000011001000000000001001100011000100110000001000000000001000000000000000000010100100100000000
