00000001000000100000010000000000000000000000000000000001000000010000001000000000000000000000000000100
00010000010010001000001001000000100010001000000010100000000000000010010000010001000000101001000000000
00111000000011000001001010100010001100011000000000000000000000110000000100000000011100100101100100010
01000100000000000010001000000000100100000100001000100000000100001100010001000000010000001000000000001
00000000101010100001000000001001100000000110000000000000000011111001001100001010000000010100100000000
00000100101110000111100000010000111100000000000000100001000000000000000000000000000000000100010001000
01000000010010000100000100000000000000000001000000000100000000011010100001000000000011000000001000011
00000010000110000000000110010100000000000000000000000110000000100000000100000000100000010110000100000
01000001000000000010000010001010100000000000000010000100100110001010000000000100000000000000000001100
00000001000100000000010100000000000100010101000000000000010000100100000000000000000000110000101000010
10000000000000100000000010000010010000001000000001000001000000000000000100100001000000100010000000001
00000010100011000000000001000001001110100000000100000100000010000010010000001000001000000001010000101
00001001100000010100010001001000000010100001111000000000001100001100010100101000000010000000100000010
10000100001000000010000000001001101101000010000100001000010000100010000011000010100000000000010000000
00000000000011010000000000000000001000000000100000000000000000000000001000011010000000010000000100100
00000100000001110000110000001010000000000010000000000000000110010000000010011000001000000000010100000
00000000000000000000000110010001000100000001000001010000000001100000000000000000100000000001001100100
00000000001001100010001100001010000000000010000001000011000000010000001000010000101000000000000110100
00001000000000001000000000000010000010100000100010100010000010000000110001000000000000000000000011000
00000100010100100000111001000000001000100000000000001001000000110001100000000000010100000000010000110
00000000010100100000001001010000100000100100000000000010001000000001000010000100000000000100000010000
00011000110000001000100000100001110001000000000010010000001000010001001001000000000000010100000101001
11010000000100000110101000000001000000101100110100001010100000000001000000000010011000001000000000010
00000010100100000000000011000001000000000110100001010001001000000011010110000010010000001000000101011
00100000000000001101000000010000000100100000100010100010000000000101000000001000001001011001000100100
00100000010001000000001100001000000000000010100010000000010000000000000000000100001000010000000000001
10100000011000000000110000010110110100100000100000001100000010000000000000010000010000100000010010000
00000011010000000101000001010000000010000101000100010000000000000010010110010010000000000000000010000
00010000000011000000111000010011000001000010110100100000100000010001000000000000000000001100000001010
00010101010000100000010110011001000000100000000000001100010000001000001000000100000000000000000000100
01001000001101110000000000010000000000000010000010010000000000001000101001000100001000000011100010000
00001001100000000000000000000000001110011000000000101001100110100000000011101000000000011001000100100
01011000000000010000100100000000000000000100001001000000000000000000001001000001000001000010000000000
01000100001100000000000000001000000010000001110000000000010001000001000101000010000000001001100000000
10100000111000000010100000101000100000000000100000000100100001001000000000111000000000001010100010010
00101011100001000000000011000100110010000010000000100000000001011000000001110000000000000000000000000
00000000000000100000000001010010000011100010000101000100000000001110000001110001100001000100011111000
00000100010000000000000000000010000001000110011100000000000000001000010110110000000010100000000000000
00000001001010000000100000000010010000100001101000010001000000000001000000000001011100000000010000100
00000010100010000000100000000100000000000000000100000010000000000000000000000000000100000010000000100
00000000000000010010000001100000001010010011110001000001010010010000010010000000100000010000000000001
00000000000000001000110000000000100000010100001000000001000100001000100000000000000010101001001000000
00000100000000011000000110011000000010100001000100000000000000010010010001001010000010000000001010000
10000011010000000000100001001010000001010000000000101010101101000100100110100000000000000011000000001
00010000000000101001000000011000011010100100100000100010010000000100000000000000010100000000000000000
00000000000000100010000100000100000000100100001000100010000000000010100010000000000010110000000001000
00010000000000001000000000010000000000010000100001000001101000001000001000000000101000000001000000000
00000000000011000110000000001000000000000000001010100010000001000000101101000000000001000000010001010
00100001000000000010000000000010100010000001000001000010000000000100000000100000000101110001001010011
10000001000010000010101000100000000000000000000000000000000000000010000010100001101010000000000000000
10011000000000101001000000101000000000000010100000000000010001001010001100110000001100001100000011001
00000000000000100000001001100000000000010100001001100000000000000000010000011000000011000000100001110
10010101000001001000000000010110000000000100000010000100000100000001000000000001000000000001011001001
00001000010000101000010101100000000000000100010000000010000000010001000000000010100000000000000000010
10000001000001000000010000000100110100100000100000100000000110001000000001010000101001010001000010101
00010101100110000000000100000000000100000000001101101000100000000000000000010001000000000000100000000
00110000000000000000010000100110101000000001100000000000100000010000000000000100000110000000001000000
01010011001000001100000000101001101001010011010010000000100010010000000000000000001010101001010001001
00000100110000000100000010010100000000000100010000111000110010000001000010101000000010010000000000000
01010000110000100000000000000000000000100001000010000000000111000000001000011010000101010000000100000
00011011000000011000001011000000100110000001000000110000000000000000000100001000010000011001001101001
10000000100001000010110000000000010000111001000000000000000010110000000000000000000010000001000001000
10001000001000010010110100001000001000010001011100000101100000000101100001010000000000000001000000000
00000000000000001010000001100100001000100000000011000100001010010000000000010001100010100100010110000
00100000000100010000100010000000100100000000000000000110000100000010000010000000101000000000000000000
00000000000000000000010000000000000011010000100000000000000000000010000000000010000100000000110010000
00100010010000000000011001000010000000100000100000010010000000000000110000000001001100000001000000100
00000000000001010000001001001001000110000001000000000000000001110100000000100010000001111000100000000
00000100000000000000000000010001000000001110000000011001000100100000000000000000100000000000000000100
00000001000000000010001100000100010100100001000000001000000100001010100000000000000000101010000000000
01000000100000000000000010010010100100000000000100000001100000011000100000000000000000010100001000000
00000000000110000000000001000000010000000000011000010000101000010000000000000000000100000000000000000
00001010100010000101001000000111000000100000000000000000000000000000001000100000001000000000000011001
00100000010000001100001100000000010000000100000000000100000000000100000001000000011000000000000100000
00000011110000101001000000010000000101010100000101010100100000000000000000000100000000000000010011100
00000001000000000000101000000010100000000000000100000010000000100100000001101110000000000000100000110
00000000000000000000000000000100000000100000000000000010000011010000000100000001000000000000101000000
00100000010000100000001010001000010110000000100000000000000100001000000100000000000011100100000000100
00000001010001000000001000000000000000000001001000000010000000010000010100000010000000000000100000000
01100101000011000100010000000000100000110100010100010011001100010000001000000010000000000000110001000
10000010000000000100000010110001010010000000010010000000000000000000100000001110000000010000000000000
00001000100010000000000000000001000010100000000000001100001111010000000110100000000100000000000001001
10000000000001110010101000111011001000000110110010100000100001000110001000010100001100100100000100000
00010011000100010011000000010000001000000000101000100000100001000000001000000000000100000001000100000
10000000000000100000000000000110000100000100000000000110000000000000101001000101001000001100000100000
00000000001110100000111000010001010000010100000001100000100010000000100000000000000000000010100101000
00010000000000000000000000001010010100100000001000000010000010000110001000100000000000000000000000100
01100000000000001000000000000001000000000000011000000110011000000000101001000100111000000000001000110
00001000000000000000100000100100000000010001000000000000001000000101000001010000000000100000010010000
00001000100100100000000110001010000000000000110000000100000100000101000000000100011000011000001010000
00001001000011100000001000001000001000010000000010000000000000010000011001000110000000000000000000000
10101001000000000000000000000000000100000010100001010000001001000000000100000010001000110000101100000
01001000010010001001000000100000000000000000000000000100000001000000000000000110000100000000000000000
00000000111000000000101011010000010110000000000100000100010001000001001001000001001000100000000000000
10100000000000010000011000001010000001000000000011010000010000000000100000000010000100000010001000001
00001000000000011000000001110000010000000000011010000001000100000000101100000110010010100000100000100
01000000000101000000000000001000000000000000010100000000000100000000010010000001010010001000000010100
00010000000000001000000000000000001010000000000100000000000010001010000000000001010010100000101010100
01000101000000000000000100000001110000010010001010011100101000000000000010000000000000100100100001000
10001000000101000000000000001111100000000100001001000001000000000000000000000100000000000000000000001
01000000000001000001010001001000000000000100000000000000000000010010000000000000100000000000000010000
