00110001000100101000000100000000000000001000000000011000000000011100000000001001010000010010000000001
10000100110000000000000000000010000000100100000000000000001000000000100000100000000000000000001010000
01100010000011100000000000000010100001000000001001001001000101000001100000001110000000000010000000000
00000100000000011001000000000001101000000000000010100000000001000000000010000000010000100011000010000
01001000000000110000001110000100000011000000000000000000000000000011001000101100100100000000000000100
10100000000101000010000000010100101000000000000001101000001000000000000000000100000010000100100001000
00010000010000000000000000010010010010010001001001100000001001000000000000000000010001110000011010000
00000000000011000000000000001010100101011000000001000010001000100010000000001000100000000000000100000
00001000011010000001010000001000000100000100001010000000000010000010000000010001000010101000000000001
00010000010000101010100100100000010000000000000000000001100001000001001011000000000000010000000001000
10110000001000000110000000010000000100001000000010100001000000000001000000000000000000000000010000101
01000001000010000011000000000000000011010000000010000000001011000000000101000001000000010110000000000
01001000010001010011000011000100000000100001000000100100000000000000001000000101000000010110010110001
01010110000100001001000000000001000101000000000000110000000000000000000000000000000100000011000000100
01000010000000000010000000000000010010001000011100010100000000010000000000000110100000100000001000100
00001100000000010000000000000010100000001010000000110000000000100000010100100000000011000000100000000
00000000111001000010000010000011100000010000000001000000000000001000000000010000011011100100000000100
10000000000000000000001000101000000010011001000010000000000100011000000000000000100000000000000000000
10000000000000000000000000000000101000000100000100000100010010000000101010100000000000001110000000000
00000001001000000000001001000000000001000000000000000000001000000000000000000001001000110010000000000
00000010000001000000110100100000100000001001000010010001000000000100100000000010000000001000100000001
10010101000010000000010000000000100000000000000000001000000010011010000101000001000000000010000111000
00000000000000000100010000000010010010000000000000000000010000100001000010000000000000000000001101111
00101001000111000000000000000000110001000001001010000001100000010000110000000110000001000000000000000
00000001010001000000000100000100001000010001010000010000000010100000100000100100000100000000000001100
00000000000010000011010100001000000010001100000000000000101000010000010000100000101100010000101010000
00000100100000010000000000100110000000100000011001010000000001110000010000000000000001100011001001001
00010000110001001011100001000000000000000000000000000000000010001000100000000000010010000100100110100
01000000000000000000000000000000010000101011000000000000001000001010010000100011000001100001000000001
00010100000010001000000000000000010000000000000001000000000100000001100000000000010100000001100010100
00000011000000001100001001000001001000010011000000000000000101000000010100000000100000000000000000000
00000000000010000000010000000000000100000000000010011000100000000000000100001001010000000001000101000
00001010110000000000000001001001000101000000000001010001101000000000001001100000000000010010010000000
00000000000010010000000001110000100000000110000000100000100010000000000010000000100000001001100000100
00000001010010010000010000010110010000001000010000100000000100000111111000000000011001000000000000000
00110010000000000100000000100000000000000111000100000101000000001100000010000000000000010000000000110
00000000000000000001000000000000010010000000001000000010100001000000000100000000000001000000000010001
00000010000000000000000100101010000001000000000101000011101000010000000011100000000000000000000001000
00001000000000000000111100011010000000000000000010000100010010100100010010100000000000000000010000000
00000100001000000000000000000000000000010010000000001100000000110100001000100000000010000010101000001
00001010000000000000000001000001001100001000000000000000001000100000011001010001000010100100000000000
00101000010100000010001001001000000001000000001000000000000000000000000010100000000100001010000000100
00001000001101000110000000000000001100010000000001000000010100000000000000000000000000001000011000000
00010010000000010010000000000010000000001000010001000100000100101010010000000000100110100001000100000
10100000000000000001000000100010000011000000110100011100010100100000000000001000000000000010010001000
00000000100001000100100000000010110001000000000001000000100010001000000001100101000100010000000000001
00000000100000000001000001001100010000001010000000001000000001011001001000000000010001000100000000010
01110000000001100000001000000000000010000100000010100000000000000000000000100000100100001100000000001
00000010010001000000000000100001000001000000000000000101001001011000100100010000000011100000010110000
00010001000000000010100010000010000000000110100000001010010000100000001011000000000000001000000100000
00000000000000100000000000001010000100000100000010000101010000110100001000001000000100000110000001010
00101000000101100010000000001000001000111010111101000000000000000000010100000000000010000000000000000
00001000000100000110001101101001000011000001000000001000000100110100010000010100000010000001100000000
11000000000100000000000010010000000000000010000000000010001001001001000000000000000101000010000000000
01000100010000110010000000000000000100101100000000000000001000100100100000011000000000010000000000010
01110000001000000101000000110001101000010010000000100000000001010110011011000100000010010000000001010
10010000111001101000010100010001100001001001011000000000101000110001000000010110001000010001010110000
00100000100100100100000000101100000110010001000010001111110000000110000010000010000000000100000000100
00000000000001010000011010001000100000000000000000010000011000001000000001000000010000000001001000010
10000000000000000000110000000100111000010000101000000000000000100000000000000000000000000000000000010
00000000111100000000010000000000011010000000000010000001001010010000000010000100000100000000100010011
00000001000000001000000000100100000000100000000000000000001000000011000000000000101000100000110000000
01000001000000000100001000000010010000010000000000001000001000010001000010100111101000000010001001001
00000000010100101100000000000001000000000000000010000000011000000011100000000101000000001001001000000
01000000010000000000100010000000000100000000000010001001000000001000011001001000100010000000100010000
00111000001011000110000010000000000000000001001001000000000000000000000101000000110000010100000010000
00001000010100010010100000000100000000000000000001000000000010000100100000011010000010000000000000000
11100000000000000000000000000000001001000000001100000010010110000101100111100000000000000100011001000
00100001000001000000000000000000100000000010100000000101010100000000000001010001000000100000100000001
00100000000000000101010000000100000010001000000000000000000000010100010100000001000000000000000000000
00000000000010000010000000000001000111001000000000001000001001010001000000100000001000000110000000001
00000000010110101000000101000000000000101000010000001000000100000000000000000000100000000001001000010
00110000000100001100000010110000010000000000100000000000000000001010010000000000001001000100000000000
10010000000010001101100000000000000000010000000000000100100010000000100000000010100000010100000000000
00000100000000100000100000000000000000001000000001100010100001001000100010000000010000000000000110011
00000000000010010010010000001110100010000100000001010000000100000000000010100100000001000001100100000
00100000000000010010000010000000000001000001001000000000001000000000001000000000000000100000000001100
00001010000010100001100000100000000000000010001000100000000001011000010000000000001001000000000000010
00001000000010110000011000101000000011000110000101010000100000000000000011000000000100001100010010001
10000100000000000001000000001000010000001010001100000000000100001000100001000000000000000001000000000
00000000000010100000000001011000000000000000000000010010000000000010000000000010000010010000010000000
00000000010000000100000001000000000000100100000000001010000000100000000000100110001000010010000010000
00100100000000100001000001001000010000010000000110100000000000000000000001010000000000010000000000000
00100001010110000000001011001000000010100000001000000000100001000001000000000000000001110110110000010
11101000000000000000000000000000000000000000000000000000000000010011000000001000100100000010000000000
00110000000111001000010011000000001000001000000000000000000000101100000100000000000000010000000010000
00000000110001010000000000000000000010001000001000000000100000000000000000000010010000100001000000000
01000000000100001110010010000000010010011000010000000001100110110100011100000001000000011011000000110
00000000010001000000000010101000010000010100000000000000000001000101000000000000000000000000010001011
01110000100000000000000000010001000001000001101000000000000010001011000110000000000000000010010100000
10000000000100100100000000000000000000101010000000000010000000101000011000000100010000000000000000001
00000100010000000010001010000100001000010000000000110000000000100100000000010000100000001000000010011
10000010000000000000000100010000010100100010000000010101000000010000000111111001010111011000011101100
11000000110000000000100000000100001001000010000000010000100000000101010000000000000000010100011000000
00000001110000000000000000100000000000100000101000000000100000000001000010110010000001000100001000001
01000000001001000000000010000010000110001000000110000011000000001000000100000000010000001001001110001
00001100000000000000000000100000000011101000000010100000000010000001000100101000000001100000001110010
00100100000011000000100000000000100000000000000100000000000100000000000000011000010000000000100000000
00011000000000100000000000000000010000101000100000001000000000000000001000000101000001101000100000000
00100000000000000010000010000000101000000000010001010000100100010101001001110000000000000000010000000
10000101000101100000000011010000000100100000000100000000000010010000000010010000100000000000000011100
