01001001100000100001000000001000000001001100000000001000100000100000000000000000010100000000000000001
00001100010010110001100100000000101011000000011000001000000000011000000000100000000100010011110100000
00001000000000000000100000000101000010000000011001000000000000010010000110001001000000100001010001000
00100000100000100001000010000001100000001000101010001000100000010001000001010100000010010010000000000
01000100010001100110000000000000000000010000101100000000100000100010001001000000000000100000000001000
00010000010000001001000100010001001000100000010000000000000100000000000010110000001000000000010010001
00000000000010000001000000001001000000010000100000000000011010000000000000000000100010000010000110000
01011100000101000000000000110011001000000011000000100000110000010000001001000011001001100000100000010
01001000000000000000010000000010000000100101000000000000000000000010100100000010000010011000011000001
10000000010000000000000000100000100000100000010100000000100000100100100000010000000000000000000010000
00000000000010001000010000010010001010000011010000000000000001000000000001000010000001000010101000110
01000000000000000000011000001001000001100001000100100000000000000000001100000011000000010000001000000
11000010001001000000000100111110000000000000001110001000001000010100010010101001001001001101000110000
00100001101000000000001000010001100010000000000011010000010000100000001101000000000010000000011001011
10010100001000011001000100000100000000000000000100000110000001000000000000000000000000000000101000000
00110000000100000000100000000000000111010100010000000011100001100000000000010000010000000001001000000
00000010000000000110001000000000000000000000000000000000011000000000100110000100010000000000000000100
00011000000001010001000010010010000010001000000001000000010011010010000101100000000100100000000000010
00010000000100010000100001000000000101000001000000000001000100000000100001000000000100000000000010000
00100010100100100000000000001000000010000010000000100000001000000000010000000100100000000010000010001
10000001000000000110000001001001110000001000010010000000000000101011000000000100110010100000000000000
00000010000000000010111000001010010010000000000000000110001000001001010000000000000100000100000010000
00001010001001000001001000000010000000000110000000010000000000011010000101000011100001000001000010001
00000000010000000010100101011000010000000000000000110010000000100001100000000101001000000001000000100
01100000000010100000000000000000010000000000010100000000000000011001000010000000100001000001100000101
00000100100000000000000101000000000000100001100110011001000110011010011000000011001000000000101010100
00000000000000000001100000100010010000010011010000000110000000000010000000100000100101010000000010100
10000000000100000100000000000000001001001010000100000101000000000010000000000101100001000100100000100
00000101110000100000010100100100000010001001000010000010000000101000001000100001000000000000000000010
00000010000000000000000000010000001000001010100100000001000101010000000001000000000000111000000000000
10010000001000010000000000100000010100000100000111010011100101100000000000110001110001001011001000000
00000110000000100101000000000001000000100000000000001110000100001000000000011000000000000000011000000
00011000000000010001000001001000000001100100000000001000000010000111010000000001000000101000100000010
00001000001011001000100000010000000000111000010001000110001000000010000000000011000100100000000000001
10000100000000000101000000000001000000010001100001000000000001010100010000001000011100000000000010000
01000001011000111010010000000000000001000000000001010010100100100001001000000010100010000000000010100
10010100000001000000000000000001000000000010000000000000110000010000011000001000000100000000000000001
00000001010000000100100001100000000000011100001101000000000010000100101101010000100101000001010100001
01000000010110001000000000001001100000000010001000001010110000000010000000110000000001010000000000000
10010000000000110100100000000000001100000010011000100001100000000000000001000000000011001000000000000
10001001000000000001000001000000001011000100000010000000000000010010110000000100000000000000001000000
00001000001000000000100100110000001010011010010001110110100000000110001000010001010100000000010000001
11000001001000000100010000000010000000000000100100001000001001110000010000000011001000010000000100000
00000000001010001010000001000000000000000100000000000000000000010000001000100000001000001100001000100
10100100000000010001010010100000011100000000000010010000001101000100100101000000100100010000011000000
10010000001000000011000000101001000000010010000111000010000100001100001000000010010001000001100110000
00000000010010000000000010000110010000000000010010000100000000000000000100001000100000000001000100001
00100100000010000001011000100000100011000000000001001000000010000000000000000010000010010000000111100
00010000011100000100100100110100000000000110110100010000010100001001000001000000010000000000001000001
01100000011000000000000000000001100000000000000000000000000000110000000000001000000110110010010001101
10000011100001000100001010001001010001001010010000110000100100100001000001000010010100101001010100010
00100001000000100000010000000000000001001000101000000000101000001000000010000000001000000000011000000
00011010100000000000001000100000000101100000000000100000000000000000100010000100000011000000000000100
01010000000000000001000110010001000010000000000000100110000010100010000000001100000000010000000000000
00000000000010100000000110010000100000000010000001000001000000000001000000000000000000010001000010000
10000000000000010000111100100000000010001100010100001010001100100000000010000000000100000000110001000
00010000010001001101010101000000011000000000011100000010000000000000000000110000000000011000010010001
00001000001000100100000000000000000010100110000000100000000000011000000000110010000001010010001100000
10010100000001000001000110000000000001000100000000011000000000011000000000000000001000010000000000010
01000100000000000000001100000000100010000000000100000010010001000000000000000010100000000000000000000
00100000000000000000000000000000000000000000000001000000000000000000100011100110001000000000000110000
10000000001001000000000000000001000000010010001000010000000010000000011100001010010000000101000000101
00010100000000111000000000000000000000000000000011000000000000001100000100100111000000110000010000000
01000000000000011000000000000000110000000110000000001100000001000000100000100001000001001100001000010
00001010000100011110000100000000000000000000000001000000001000100000000000001000000000100000010000100
00100000000010100000000000000000000101000100100010000001000000011101000010001000101000100000001000001
00100100110000000000000000010000000000000110101000000000000000000100011000000100010100010000010000000
00000000000000000001000010000010000000000000100001011000000000000010000000000000000000000010000000000
00000000010011100000100001000000000100000011001100010000000000001000000010000100001000000001100000000
00001000001010100000000000000000000000010000000000000010000011000110101000000000010001000000100000000
00000100011000101001000001000010000000000101001000000010000000001000010000110000000100000000000000000
00100100001000010000000100000000000010101000000000100000000000100101000001010000000011010011100010000
00011000000001010001100000000111000000000010011000000000000001001000000000000010000000000010010000000
10000000000010100000000000000000001000001011100001010000000101001000000001000001000001100000000011000
00010000110000100000001100010000100100011101000000000000010001000000000001000000000000000001000001000
01011000001101100000000010000000101001001000101101000000000000000100100000001100000100010010100000000
00000000100010000000000000000000100010000000100000000000000010000010010001000000100010001010000000000
00000000000001100000010000010110000000000000010000000100001000001010100001110000010000100000101010000
00100001000100100000001000001100100010000111000110000000010000000010100001010100000000000000001000000
00000010100011000000000000000100010100100000000010101001000000010000000000000100000100101010000100000
00010110100000100000111010000010001001010000010000010000100001000000000000000000100000000100000000000
00010000000000000100000001000000000000100000000000001010000000100010000000000000101000000000000110000
00100000001000000100000000000100000000100100000000000011001100001000000010000100010000101000000000000
00000000000000000000000001000101100000110000000001000000000000010000100100011100100110000000000111000
01010001000000000010100000000000000100000000010000010100001101110000110001001000101000100000010000000
11110000000000001000010100000001000100001000000000000010000000100000100000000000010000000000110010001
00000000000001000110000100001000001000001000000000000100000000011000110100010000000100100000010001000
00000000000001000101000000011001000001010110010100001000000000000000000000000100000000001000000000010
01000001000010000000001000000000100000011000110000100000100000000010001010010110100010000000000000000
01000000100000000101000000100001100000000000000000010000000101000010010000100010000100001000100000000
01000000100000000000010000010110100001000010100010000001000100110000001100100000000000001000000000100
00100001000000000000001001010100000011000000000000110001000010001000001100010100100000010100000000000
00000000000010100000000000000000000110001000101001000000100000000001010010011001100010100001000010010
00100010000000000000100010100011000010010000000001100000000010000000000000000000000000000000000000001
00001000000001110000010000000010100011000001000000000000000000000000000100100000000000000000110000010
00000111000000000010000010000000010000001011000000100000000100000011001000101000100101011000000101000
00100100000010000010001010000000000010000100001010011010010000000010000000000010000000000000100000010
10000001000000010000000010000000001010010000000000000000000001100000000000000100100000000000000001110
00000000000100010010000000000010000101000010010000010000110000000000000101000011000000011110000100000
00000000010000000000000000000010000001001000000100000000001100100000000001100000000000000000010000000
01000010001000000010000000000010010110010000000010000010000000001000101001000010001000010001000000000
