00000000010000101000000000100000100010100110000001100000001000000001000001000100100010010010100001010
01011001000010100000000000000010100000000100000100000000000110000100000001000000000000000000000001000
00001100100010010000000011000000000010000000001101000101000110000001000000000000001000000000010010000
01000110001010000000000000001000010100101001010001100000000000101010000010000000000000000000000011000
01001001010101001000000101000110000100000001000000000010000000000110000000000000000000000000100011001
00000000000110000000110011110000000000000000000000001000000000001000100000100000100000000010000001000
10100000010000000000000000000000000000010000100000000110010000000011000000010000100000000101001000010
10000001010000100000000110000000001000100000000001001000001000000100000000000001000011000000110100000
10000000000101000000100000000001000011000000000100001100100000000000000000000000000001000000010001000
00000001010101000011000001000000010000001000000000000001001100000000010000000000100010000000000000000
10000000110100001000000000010100000000000011010000011001000000000100010011000100001000000010010010000
00000000001000000000010000000001000000111010100100000011001010001000100000111010000000001100100000000
00000000000000000000001000010000000000011000110001110000100100000000100110001000100001010001100010000
00000001100010000000001110010011000110000100000001000010000000100001010001100010000000000000000010000
00000100000000001000000001000001000000000000000011011010001100000001100000000010000000000000100000000
11000000000000000011000001000000010000000000010010000000000000000100000100000000000001010000100000001
00000000000100010100001010001001000000010000010000001000000111000000001001001000001100010111010100110
10000000000100000001000000000000100000000000000000000001000000100010000000100100010100000001000001011
00000000100010000000000001001001001100011100110001000000000100001001110001001000000100010001010000100
01011001000010000100000000010000000000000000000000100000000000000000000000010000001001000000000000010
00000001000000010000010101000100011110000000110101000000101000000000010000000001100000000000000000000
00101000000100100000010100000011000000000001100000000000100101000000100000000001001001011000001000010
00000000100000010000000011001010100000010100100000000000000100100000100000000000100000010001000000100
10000010000011001000000000010000000001000010010000000100000100010001000000000100100000001000101000000
00010100000100011000000000101011000000000000000000000000000000000100101100000000000000000100000000100
00010100000000001010010000000100000000000000000010001000011000010000011011001000000000000011000100010
00001000001000001000110011010010100010010001010000010000000000000101000011000110000001010000000000000
01000100100000000000010000000000000010100010001000000000000000100001001000000000000010100000100011000
00100000000100000100000000000001100001001000000000000000111001100000001000000100000001010110001101000
10100000000000000000000000010000000000000000010000000011000100000000000000001000010000000000001000000
00000100000000000000100000000111000000000000010000100010000010000000000000001000100100000000000000000
00000000000000000001100010000000000000000000100000110110100000000100110101101100000000100000000000000
00110000000100000000000100001000000010000010100110000000000001011010100000000001000000000100000000001
00000000011000000000000010000000010001000011000000000010001010010000000000000000000011100000000111000
10010000101000000001000001000000000100010000000000100000000000000100010101000111000000010000000010000
00100000000110001001010000000100100110010000010000000000000000010010000100000000000010000000000000000
00010000000000000010000010110000010000000110100000000000000011000001100110000000000001000000000000000
01001011000010000010100000010000000000010001000000011000000101000000010001000011000000101000000000001
00000000001100100000000000000110100000000000000010000100000101010000000010001001110001000001000000100
00001001000000000110001001010000000010001000000000010000010010000000001000000000001010000001010000010
10000000000001011100000010000000000000101000000000000100000010001001001000101000100000001100001010110
01010100100000100011010001100001000100000010000110000100100000010000001100000001000001000000011000100
00000000000010000000110000000000000001010000001000001000101000000000000000010000011000000000100010110
00001000100000101000110010001000100001000000010011001110000000010001000001100001110000010000001001000
00000010001000000101100000100000000100000001000100010010000000010010110000001100011000011110000000000
01000000001001100001000010000101000100001001010000101000000000010000100000011100000001000101000000000
00000000000000101000010011100000000110010000100000000000000000100000000100100000000001010100000000011
00010000000001000000000100000010000000000000000010000000100000000000001101011001000100000000000000000
00010100000000000000100000010010010011001010000000100000000001100000011000010111000000000000100001110
00100000000000000010000110000000000010001100000001000000000000111100001000000000000110000000100100101
00000001010110000001000100000000000000000101000011000000100010011000010000000100010000000000000000100
00000001010000000100000100000011100100000000000100000000000010000000000001010000100000000000100001000
00010010000000000001001000001001000000010010000000001000010010000010010100000000100000000000010000000
00000000100100100000001000000000100101000000100000010000000000011000011001000110000000000000110000100
00000010000000000000000000000000000001000000001000000011100000010000001001001000000000101101000000010
10000000001000000110001001000000101100010000000100000010000110000100000001010000000010000000000000110
00000001001010001000000100000001000010000000000000000000000001001000100001100000000000111000000000101
00111000000000110000000000110000000000000010001000000000000100000001001010000000000001000000100110010
00101000000000000000000000001000101000001001010100000000000001000100000000010000000000010001000000001
00001110100110000100001001000000000000000000000000000010001010010101000100110000000000010000001010000
00000000011000000010000000000000000000000010000101000000001110000000101000100110000000000010100000000
00000000000001000000000010000001010011100000001000001000000001000000000001100110000000000000000010011
00010000001100000010000100100000000000010000000000000000010000000010000110000000000010010100000100000
10001001000100000010000000000100000010001001000000100001100001000000000000000000001001010010000000001
00000000000001010000000000000000000000001000000100010000010100000000001000000010001010000001000000010
00000010000000001000001000000100000001000000100000000000000000000110000000000001001100101000000001000
00011100000010100000000000010000000111100000011101100001101000000100001000100001000000000000010000000
00000100001101000000000000000000000000001100000010100000001000000101000001100100000001000000100000000
00000000101000000000010010001010000010100010000100100001000000000100000000000000000100000000010001000
10000000000000001000000010010011000000000101010000101000000000100001000000000000000000000000100101001
00000000101100000010000101000010100001000100100010000000001001100010001000000100000000000000000000100
00000000000100100000000000000000010000010000000000000010000000100100000000010000000000011001001000001
00001010110000100001000010000000100000000000000000000000000011000010010000001100000100101001100100000
00000101000000000101000000001000000010000100000100000110000000001100000000101001000000000000000000010
00000010000110000000000000010001000110100000000000000000001000011100010000001100000001010001011100000
00010000000010000000000000000101010100000010011000000000001010100000000011000000000000100000000000010
00010000110000000011000000000011011000000001000010000000000000000000000000010000000110011100100000110
00010010000011000001000000001100000010000010000000000000100000010010000101000110010000000100100000000
00001000010000000000000000100010010001010000000000000000100000010011000001000100000000000010101000000
00000001000000000001100001000000100001000001001001110000000111000100011000000000000010001010000001100
10101000000000100000000010010100100000010001000000001001000100000001110010101000001000000010000000000
01000000000000100100100011001010000000000000100000011000010000000010001000000000000000000000100000000
00000100000010000001000000000000000000000010000000001001100110010111001000000000000000000000010000000
00000000000000000000000000111001010000000000110000001100000000000000100000010001101001000000100000000
01010001011000100010000000010000011000001000111000000000000000000110000000000001000001000001010101001
10000000000010010000000000000010000101000010000000000110000001000100010001100000000000000001000000000
11010001010000101001101000000000000000000101000000100000000011010000000100000001000001000000001011000
01010100000000000011100010000010010000000000010010010100000000000011000000010000001110000000000110000
10010000100100010000000000010101000000000100000000000000010010000010000100010010010000000001000010100
01000000000000001000000001000000000000000000000000000001000010001100001000000001100011000000000010000
00100000000000000000001010010101000000100010000000000100000000000001000000000000001000000100010001010
00000000100000110001010000110010000001000100100000000000000000000000000000010000100101000010000000000
10100010000000000011000000000001000110000000000110000000001000010000000000000110010010100000010000000
01100001010000010000010000101000001010000000000000101000010010001101000100100000010001110000000101100
10000101000000000001000000001100000010000010000000000000010100001000001010100000000000000100000000000
01000000001000011100000000000100100100000000000000000000000000100000001101000000001000001000001101000
00011001010000100100100000000010000010101000000000000100000000000000100010000000000100000100010001000
00000001011000001100001010000000010000001101000011100000000011010000001100010000100000010010000000000
10100000110000010010000010000000000000000000100000010000000000010000000001010010010111000010000010001
00010000000100000000010100000000000010000100001000000000000000000101000000010000000000100000000000110
00101101010000100100000011001101100000000000000010100000000000000111000000000100000000000001000000000
