00000000110100001000101010101000010000011010110101100100011000000001010000001000000000001010001001011
01010100000000001001000000010000001010000000100000101000100101000000000000000011000010000000000000000
00100100011000100010000010000001000000000001000000000000000010010010000101101000100001010100000000001
00100100000010100010000010000000001000000000010101010000000100000000000010000000000011000010000000000
00001000000010000000000100000010000000000000100000010001000100000001000001000000000000000001000010000
01010000010100000000010000010000000000000001000000000000001101000001110000011100000000000001000100000
00100010010001000010010000000110100000000000000010010100001000010000011000000000001010000110010001001
00000000000000100100001001000100000001000110000000000000000000100010000010001100000000110000100011000
00000101000000000000000001010010000000000100000000100000010100001001000010000010000001110100000100000
00000010000000100001000100001000000000010001000000000000000001001001010000000010000011000000000100101
00000000000100000000000000000000000000000010010001000001000000000000000000100010010000010010000000000
00000100000000000000000110001000000010011000000011100000100000001111000000000010100000010000100000000
11000001000000000000000100000010000000000000010000000000010000000000000000010000001000101000000000000
00010100010001000000101000000000000001001000000001000000001000010010000010001000000000000000100000000
00010000100000011110101000000000000000001000001100000000001101000100001000000000100000001010000000000
11000000010001010101000000000000010010100110000000000001000010100000010000000101010000010000000010000
01111000000000001001010100000000100011100000000100110000000000100011000000000000000011100010000000000
10000000000000001000000000000100000010010000000001001000000000010011000100000000000100010001001000000
01000101000010101000010000010000000000100000000000010000000000100110000010000000000011010001000001010
00000000010010000000000000100010001010010000001000000000000000000000000000000000001001000000110000010
00000010000010011110000001000000001100000000100000000000100010010100010110011001100001010011100000000
00100101000000010010000000000111000100100000100000000000000000010100001101010001100000100011000100001
00111100010000000000010000000101000100000000000000100000010010000000000010000000000100001000000001101
00000000100110000000000010000100000000000100000000000000000100000000001000000010110000000010001000000
10000000100001000000000000001100101100001000000010010010000000001000000001001000100100000001000000000
00010010100000000000001000000000000000000001000100000111000001110000000000000000000000100010000000010
01100010000000000011001100000100000100010010000000000000000000000000000000000110000001000101000011000
00100000100000010000100000000000100000100000100100000101001000100000100000011100000000100000001000000
00100001100000000010010000000000000000000111001110000001001000100100000000010100100111100000000001011
00100010010010010000000000000000000100000100010000001000000001001000000100101100000100000000010010001
01000100000000000100000010000001000011101000010010000000100100000000000001011000000100001100000100000
00011011101100000010000000000001100000100000110010000000000000001011100010010000000100000001000000000
00001000000000100001000010100010000001010000000010100000010000000000000000000000100001000010010100001
01000100000001010100000000000000100000100000000000001001011101000000000010100000010000000000000011100
00000000110000101000001001000110010001010110001100100000000000000000000100010000000000001000000000001
00000000000100000001000100100000010000001000000000000000100111000010000000100010100000001000100000000
11000010000000110000000000000000000001000010010000010000000010000010000000110001000000000000100000001
00010101001000000100010000000000000000010010000100000000000010000000000100000000000000011000100000010
00000000000001011000000100000010000001001010010000000000011000000000001011010000000000000000000000000
10000000100000000000000000000001110000011000000000001010001000000010000000000000000000000000000100101
01010000000000000000011011000000000001100000000000000000000000000000000011010000000000000001010000001
00100100000000101000001000000001000100000000000000100100000011001000000000001000000110000000000000001
00000010000000001000000000000111000000010000000100000000000000000000000100010000001000001001000000000
00010000100000000010101000001000000000000010000000001001100000000011100100010100000010100000000000000
00000000100110000100100100000001100000010000000001000000001000000010010000000000000010100000011000000
00000010100000001000000100000000000011011001000000001001000000000000010000001110000000000000000100000
01011000000100110000010000000010100001000000000000001000000000000101100011001001001001000000000100010
00010000000011000000000001000000000000000001001010000000010001010001000000000000000000000000000000000
01000000010000100000000001000000010000010000000000000100000100100101000001101000000001000001000000000
10100000001000000100000000000000000000000100010000000101000010000000010001000010100001000001000000000
10000000111000100010000100000011000100001001011001000100000000100000000000000000001001000100100000000
01001000000000000000110000001100000000000001000000100000000000000011010000100000000010000010100000000
10010000010000010001100000010000000000000000111000011000000000000001000010001100010010001010000010000
00100000011000100000010000100010010000000000000010100010010010010010000010000110110000000001100000000
00011110000000010100000000000000000000101100000000000000100100000000000000100000000000000000000110000
10000100000000010000000000000000001000000000000000000011000000000001000000001000000000001000001000001
00000010010000000000000100000000000000000010101010000100000011100110011000001000000001000010000100101
11000000000100000011110000001011000000010000000000000000000011111000001001000001010000100000000000000
00100000000000000010100000100000010000000000000011000001010010000100000000001000000000100000000001100
10101011000001000000000110000100000000001000010000000110000100000001100001010000000000001000100000010
00000000001000001000010000000000101000000010000000000001011000000000100000000001101000010000000010010
10001000100010000000001000000100000000001000010000000000100000010000000001010000100000001000000000000
00000001010001000101010001100000000000000010000111010000001000000000110001110000000000001010000100000
11101000000000001100001000100100000000001001010000100001000000000000010001000000100100100000010110000
10000000101000000000000001010101001000000110001000000101101000000001010100011001000011010000110111000
00001010100010100000100000000000010000010000001101000100001110010100000000000000000000001001000001001
10000000000001001100001001000010000000001010000000100000000101010001000000010010000101010100100000010
00001000100000101010000111000001010001100001110000011010000101010001010100010000000100001010010001100
00000100011000000000000000100000100100100100000000000000000010110000000000000001000000000000010100000
01000000000010000001100000100000000000000010101001001000001010000110000010000000001000000010000000001
00010000000000000100011011110000000000000001000000000000100010000010000000000001000001000010100101000
00010011000000000100010000000001000000000001010000000010001000000000000100001010000000011000000010000
01001000010000000000010101011001000001010001001000000000100000101000000000000000000010100000100010100
10000000100000000000100010000000000010000010000000000000000100001000000100000110010000000000011000010
00000101001000100110000000000000000000011010001000110000000100001110100000000110000100000000000001000
01000010000010110100100000101110000000001001000100010000000001000000010100000010100000000100010010000
10100000100000000001000010001110000000100000000000000000001000000010010000000000000001001010000000000
00000000011010000001000000000000001001000000000100010000101110100001001011000010000000001000000000100
00000100000110000001000111010000000000001000000000111100100000010000000010000000000110000000111000010
00010010000000000000010000000000010010000110100000001000001000011000000001000000010000000110000001000
00100001000000100000000000000000010010000001000000000000000001000000010100010001000101000000100000001
00000010000000000010000000000000001000000000000100000010000000010010100010010100010000000000000000010
00000000000011010000010001100010000100110000000010000000001100001100000110000001000000000001000011000
00000100100001101001000100001000001000000000100000000000000000000000000000000000011000000000000000000
00000010001000000000010100000010001000001000110000000000000000000001000000010010000000100000000000011
01000100101000001000001000011001000010100010100001001000000000010000000101000100001000000100000000000
00100000000000001000100010000000001010000000001011010000111000111101000001100010000110000001000001000
10000000010000000000000100000000000100010000000001000000100000000101100000000000100001000000000000000
00000000010000000110110000001001001001001000010000100010010000000000000000001000000101000000000000000
10000100010001000000001000000000101101000110000000101000011000110000000010001000010001000011100100000
00000000100000000010000000000000001000000000100000000001000100011001000000100000000000100001000000010
01100001000010000100000000001000100000000011100001010000000001001000000010000100010000000100010000010
00010000000000010000001000000001000010110011000001000000101000101000000000000011001000000000001010001
00110000000001000010000010010001100100000000010000101000000000100000011001000010000001000100000110001
00000000000100000001010110000100010010001000000010001000100000000000000010000000000100100100011011000
00110101001000001000000000000000000001110101000010000000000000000000000000000000000010000100100000000
00000001000011000001000010001000000000100010010110100000000000100000000010000100000001100000000100100
10100000000111100000000110000000100000000001100100000010000000000000001100000101000010000000000000000
10000001000000000010000000001000000100101110000100000001000011100000111010001000001000000001000100000
00010000000100000000000010100001000010000011000110000000000000000000000000000001001000001000000101000
00000010000001000000000010010000001000001000000110010000001000000000000000000000010010001000000110000
