00000000000000010010001010000000100000000000000000101000001001110000100000001001001001000000011100000
00000000100000001000000001000000000000000000000001000100000000010000000000101010000000000010000010010
01000101000100000000010010100000010100000000010000000000001000100010000101101001000001000010100100100
00000000100100001010010001001000000111000100100000000000000011010001000000001000101000011000101000000
00000100000001001000000000000000000000100010000000000000110110010000101010010000101000001010000000000
00010001010100000000010000001000000000110001000000000010001001000001010010010001000000010000010000000
00110000000000010000000010100001000010110000010100000000001000000000000110001000001000010000000000000
00000000100010001001001000000001000001000000000010000000101100000000110000100100010000000110000001000
00100010000000100000000000000100101001000000100110000000000010000000000000001000010010010001000010100
10000010000000010001000000010100000001001000000000000000000000010000000001010001001001000010000010100
10000000000100000100100000010001000010011010100000001000100000110101000000000010000000000100000000100
10000010001000000000100000000000000000101000010001010000000000001100000000001000100010101010010000000
00001001000011011100000100000010101010000010000000001100000000001100010000000001101100000000000100100
00100000000001000100010000001001000000000000010100101000000100000000011000000000000000000000100010000
00000100001001110110100000000000000000001010000100000000000000000100000000001100000001000010000000010
00010000000001000000000110011011001010001101000010010001100000000000100100011000000000000010100010000
00001000000000100000000000010000000110000000000010000010000010000000000000000011000000000001011000000
00000100100000000000000100000001100000000000000000000001000010011000000100000000000000100100100000110
00000000000001000000000100001110001001101001001000000000010001010000000010100000010000001000101000000
00000100000000001100000000010000010100001000000000010000000000000100000001100000001001000000100000000
00100010000000100100000000000101000000000100100000000000000000101000100000000000000110000100101010101
00000000010000000000000010000000000011001000100100000001100011100000000000000000010100000100000010000
10100000001001000000100110000100100000000010100100010000000010011100000000100100000100000010010001100
00000010010001000000000100001010000010010111000010001100000110000000000111001010000000000000110000000
00000000000000001000000001000000100000000000000000000010100000001000100000000100000010100010101010001
00100000000100000010000000000000000000010001100000000000010100101000001000001010100010000001011000010
00000000000010010010000010000100001001001100110001101010000001100000010010101110010000010000100001000
00100000010011010010000001000001001100000000010000010010001100010010011000000000000000010000011000100
00010000000000001100001000001000000000100000110100000000000000000000000000000000000010100000000010100
01000101000100001000000011000001000010000000000001000001000000100000000100100000010000000000000001000
00000100000000100000001000000011000010000000010010000000100001011000000001000000001000000000100000010
01000000000001100100000000100000101001010000000000000000000011110000000010000000000011011110011001001
10010000110000001000000100000101000110000000000000000000000000000000101001101100010001000000000001000
00000000000010000000100000000000100001001001000100000000000000000000000000000100000100111010110100000
00000000001001010001000010001000000000010000000010100010000000010100000000100100001010110001000000001
00000000000010000010000001000100000011000000000101000000100000110010000001000000000000000000100100010
10001000000000110101000010010000000010100010000001000000000001000001100000110100000100000000011001100
00010000000000000100000000010000011010000001010000100001010110000100100000001010000000001000100000000
00011001101000000000001001010000000000100000000000000000001000000000100000010000000000100000000000001
00000000000000000000000000100000011100001000000001000011000000000010000000001000000000000010000000100
10000000000110000000000000011000001000100000000100000010000010000000000000100000010000010100001000110
00000000011010000100000000000000000010011010000000000100100000000000011101010100000000000100011000000
00000011000000000011000000000001010000001000001100011000000000100001100100000000110000001000000000000
00000110010111100000001000000000100000000000001000000000000001000010000100000000001001000001001000001
00000000000000000000101000000000000010000000000000100010000100001000110000000100000011001001000000110
00000010000010000000000000000000010100000000000000000000000000010000010000100010000000000110010000011
01010000000010010000000000001000001010001000010010000000000011100000000000100001000000001000000110000
00000000010110000000100000000000001000010000100000011000000000010001000000000000010010000001000000010
00000001000000001000000000000000000000000000001000100010010000100000000000010001001000000000100001000
11110000011000010111000000000000001100100001000100001000000000000001000100001000000010000100000000010
01010000000011000000000100100010000000000000000000010000001000000010000000011010000000000101000110100
00000010001000100001000110010000001000000001000100100010010000000100000001010000100000000001000000110
00000010000000010011000000001000000000100000100000000000000000100000100000000100000000100010100000000
00000010100010000000100000000010001000100000000100001000100000001000001000001100000000000000000010000
00000000000000100000000000000000000000000011000000001000000000000001000000100000100001001000001010010
00100100000000000000010000000000000100000000000000000000110000000100000010000010000000000100110000000
00001001000001001000000000010010001000100000010000001000001110001000101000000101100110000000100100101
00100000000000000000000001010001000010000000000000010000000000010000000001011000000000000111000000110
10010000000000000000100000000000000101010000001001100000000011000000000000101010000000000100000000001
11010000000000000001010001010001001001000000010000000010000000000011000000110000001100001000000000000
00000010100010010001000000010101011000000010000000100110010100000000000100000000000000000010001000000
00000000000000000001001000000010001010000100000100000000011010000010000101000000110000000000000111000
10100000010000000010010000000000000000001001000100101011000011000000000001000010000000000100010100010
10000000000010000001000010000100000010000000000001001000000010000000001010000000000000100000000110001
00000000000000000100000111000001000000000000001010000000000001001010000000100100000101011001100000001
00000000000001000000010001000000000000100000100011100011001000000001000000000001000100001000001000100
00000000000000100000000000010000000001101000001000100000011001000010010001011001000000000010000110100
01100000010000000000010010000000000000001000001001000011000000000010010000000010100000000101000100000
00000000100000000000000000100001000000001011010110001010000000010000000000000000001100001000000000000
00110000011000000001010010010001010010000000000000000000000110100010000000000000000000000000000000000
00000001000010000000100000000000001010001000000001110000010000000010000100010000001000100000110000010
00000100000000000000000010000000110000100000001000110100000000000110000000000001000000000011000100000
10011001000000001000001000100001011000100001001001010010100000000001000000000000001100000100001000000
00000010101000000101111000000001100010101000000000000010100100000000000001001000000000111001110100000
00000000110000000001001001010100000000110000000000000010001000001100101100000000001000010001001000000
00000000000000000000000000001000010000010010010110000000000000000000000000101000000000000001000000001
00000010100000100000000100000001001001001000000000001111010001000000010010000000100001100100001100010
00001010000101000000000100100000000100000000000000001100110001001110000000100000001110000011100000000
00000110000010010000001010000000101000000010010101001000110000000000000000000110100110100000000010010
10000000101000000010000000100000000101000000000101000010000001010010001000000000000000100000000110001
00000000010101000110101000000000100100000000000101001000000000000100000010000001000000000000011001000
00000100001010010101000010000011111100001000000100010100100000001000010000000000000010000000001000010
10000100011000001000000001000000000000000000001001000000000000100000000000101010000000000000011001100
00000000001110000000010000100000001000000000001000100000010011010000000010000000000000010000001000010
00000110100000000010000000000001100000000001000000010000000100000101000000100010100000000001000000010
00000000001000000001001010001101010010000000000000000100000010010010100100000000100001000001110110010
00100000000100000000001011001000101010000101100110011000000000010000001001001000000000100101000000100
00000001101000001000000001000000000000000000000001000000001000010000000010010001100010000010000101000
00101110001000010100010010000001000000000010001100000001001101000010001100000010100000110000001000000
01000100000001000000001000010000000100000000000101000000001000001000001010000000000000000000000010000
00000001011100000000000010000000000100000001100000001100011010000001000010000000000001000000000000000
00000000000100000111001011100000000000000010000001001000000100010000000000100100100000100000000000010
00000000001000000000000010010000011000000010000100001010100101010100000001100000000000001000101100000
10000100001000000011000010000000000000000000000000001100000000000000000100000000000001001010000000001
00000100000000100000000001010010000100010000100000001010000001000100000000000000100110000001000011010
10001011000010001000001000000000000000010000000010110001010000000000001000010000000000000100000110001
10010000000000000001000010001010000010000000000000000010010000000000001110000000011000101010111001010
10000000001100001000000010000010100000100100000000000010000001011001110000000000000010001100010000010
10001000001100000000000000010000000000000000000000000000000010010000000000010000000000000100011000000
00000100000001010100010000000000000001011000000000100110000000000010000001000010000000010000001000000
10001010000000000000010010000001000000001000100010010000010000001101100110000001001000000001100000000
