00100001001001010001000000000000010000010011000000000000001000000000010000000100000000001000000010001
01000000001000000100010011010000000001010000000000001000001000010001010000000001000100000100011000000
00110000000110001110000001010000100001000000000000001100001000100001100100100001000000100100000000010
00000000000001000000010101000000000000011000100000001000000000010000000000000100001000000000100000000
11000010000101000000000100100000000101100000110000000010000100000110000010000000100111010000001000001
00010100101001001000110110011000100000000000000000000101000010000110000010011000001000001001000000000
00001010000111001000000100000000110000100000010001001010010000000010000000000000000001000010110000110
10000000000010001010010000000000000100101000010000000100000000110001000000000000100000000000100000000
11000000000000000110001000000010010001001001100001111000110000000001000000100000000000001000000000000
10000010101000110000000100010000000001000000000100101001001000001010000000100100000011000000000000110
10000000100000000011000111000000100000000100111001000011100000000000011111000100010001010000000000100
10000000001000000100010000000010000001000010000000000001000010100010001000000000010100000100010000000
10110100000010100000110000001100010011100010000000000000110001000000000000000100100001001000000000001
10100000110010000000100100000011010000010000000001100000000000110000001010000000001000000000100100100
01000000000001000011000101011000000100000000001000000010000011001100000001000001000100101000010110000
01101001100000001101110100000000001000010000100010100000001000000011000100000001000000010000000000000
00010000001000001000100000001000000000010000000000000000000000010000010100000000100001000000000000000
00000001010000000010100010000000000001000001000010000000001000110000000000011010000000100000000000000
00000001001010001001000000100000001000000001000000100000000000000000000010010000000000000000000000001
10101000000010000000100001000000010010011001001100100110100000000000010000010000000000000000010000001
10100000011100000000110010000000010000100100110100110101101010000000100001010000100000000001001000010
00000100000011010000000000010101100000000001111000001000000000110010100000000001001000000001010000110
00000001000101000010000010101000010000010000000100000010000000100000010000000001100000000000000110000
00001000000000000000100000010000000000010000000100010000000000010000000001000000100001100100000000001
01001001000001000000000000001010000000000001011000000001000100000100000000110000000011000001000001000
00100011100100100100001000000000100100000010000000000000000010100000100011000101000000001000100110000
00000000000000110000000001010000011010000110000000100000000000000001100000010010100000001010000000000
00000001000000101000000000000000100010000000000001010010000000000000000100000110000000010111100000000
11000000010000100001000010000000000011000001000000000011000110000001000001100000000000000000101001101
10000000000010000000000000000000000010010001000000100000000000000100110000100000000000001000001000000
00000010010000010000010011010000000000100010110110100000100100000000010001000100000000000010000001000
00000110110000000101000000000000000000000000000100000000010000000000000001010101000000000000000100010
01000000000000000000010010000010100010000101110010001001000100000001000001100000110000100000001110000
01010011000100000001001000000100000000000000000001000000001000010100000000000010001000000000000000000
01000000000011000010001000000001100000001000000000010000000000000000000000000000001100011000000000010
00000000000010000011100000000000010000000011000000001000100010001101010010000000100100000000011001000
00000100000000000101000000010000110101000000000100000010000000011000000000000000000000001000100011100
00000110000110001000000000100000010000010000000000010000110000000000010000100000100000000000001100001
00000000000000110100100010000000100000000100000000100100000100000100100010000100000010000000000100000
00010010010010000000010000000000000000100000000000010100100100000000000101111000000000100000001001100
00001000000010000000000000000000000001010000101010000000100000101001000100100100000000000000010100111
10000011001110000001110001101000010000000000000000000010100001000001010011110001000000000010100001001
00001100000000010000001000001000000010100000000001000000001000000000000000000000000010100101000010000
00001000001000000000000001100000000000000000100100011000000000101000000100001000010000000001010010100
10001010001000010000000010100100010011001000110010100110000011000001000000000100001010000000110000010
01100000110100001000000010001000000010000010000000010000000001100011000000001000000000110000100000010
00001000110000000000000000000100000000000100001010000000000100100100100010000000101100000000000001000
00000110001010000001000000100000010010010100000000110001010000000000000010000110000010001010010000100
00001000010000000100000111000110000010100010000000000000000000110100000011001100100110000000001010000
00001000100000100001000001000000000000101000100000000000010010000100000000000000000001000001010001000
00000000000000000010000100010000010000000000010000001101000001100000001000000000010100000000000001000
00000000110100101011010010000001100000000000000000010000000000000000100000000000000001100010000100100
01001000000011000000000010000000101100000001000000010100100000010110000100010000000000010000000000111
10001100010010110001000000000011000000100000001000000000000110001000000101000000100000101110110000100
00001000110100101000110001000000001001000000000000000000100010001000011000100001001001000000000100001
10000000000000000000000000000010100000000000001000100000000010110010000000010010000000000000000000001
00000000001010000000000000111000010001000010000001000000100110000100000010001000000100000101001001101
00100100001010000010000010000000001001000000000001010010001100011000000100110010100000000000001000010
00000000000000000001000000100000011000000010010010100100101000000100000000110000010100101100000101000
00000000000000000000000000010000000000110000000100001000000000010000000000000000000101000100000000000
10000000100000100100000100110000000001000000000000011000010000000000001001000000101100011100001000000
00000000011000100000100000100000000000000000010001000010000011000000000000000000000000000000000100001
00000000000010000100100001001000000111000000000000000110010000100000010100000100000001000000010000110
00001001000001100000000000011000100010010000001001000000000100100000000000010000100011001000000000000
00000110010010100010110010000000000100001000000101001000001000000000001001000001000000000100000001001
10100000000000110000000001100000000100000000000000100000000001100000000010000000011001010000011000100
00110000100010000000000010010110011000000000000000100000000000101010100000010001010110100000000000000
00000100000100000000101000100000010000011000010010000000100100000000100000000000000000100010000000001
01001111000000000001010001010000000000000000001010010011000010000101000010011000101000000000010000000
11000001000001000000000001010001000000000001000001000000000110001001000000000000010000001000001100000
00010011001000000000001010000011000000010010000000001011000110000100000110001000000010001111101001101
00010000001110011000101000000111010000000000000000000000001010100000000100000010100000001001011000000
10000000101000000010010000000100000000000010000001000100000000000000000001000101100001000110101000000
00000000001000000000000100100001000001010000000000001100100000001000000010000000000000000000000001000
00000110000000100000110000000001000000000000000000000100010000001001000010000100000010000100001000010
00001000000000011000010000010011000100000000000000000010010001100000000000100011000010000100010000000
00100010000010000001001000010010100000100001000000000011100000000000000100100111100000011000001001000
00010000100000100010000100000000101100011010000000000010001001101000000100101010010000000000000000000
00010100010000001000100100000010000000100000000000010000000000100000001000000000000000000000001001100
01110010000010100000000000000001000000001100001000001000100101000010110000000001000100110011000000000
00100100000010010000100000000001000010000000100000010110100000000000000000001000000101000000000000000
00000000000011100000100000000001010000010000010000001000000000000000100000001100000010010100000100010
00000000110001001000000100000000001000010001110010100000000100000001000001001000100000101001000010000
00000000000011001001010000100100100000101000100110010100000100001000010010001010000100001000010001001
00000010000000101000000100001010000000000001000000000010000000010000001000100000000000000100000101000
01000110010011001001101000100010001000110100000000100000000100000000000110000010000100000010100000000
00000010001100000110000100000000000000111000000000100010000000000000000000010100000000010000000000000
10000000001001000010000100100010000000000000011000000001000000101000010000100000000000001000110100000
00001000000010110000000000000000000110000000000100000000000000000100001001000101010100010000000010000
00010000000110001001100000000000000000001001000000011000000000110000000000100100000000001000000000101
00001011000010000101000010000100000001100100000100000000010000000001000000010010000000000001100000000
00001000010100010010010000000100000010000000010001000110000000010000010010000011000011100000000100000
00010000010001001110001000000011010010100100010001000000011000100110000100100100011001010000100000010
10100100000001000000000011001010000101000100100000100000000000000101000000000000000000000001001000000
00001010000100000100000010000001000000100000001010010000000100000010000010100000000010100110001000000
01000000000000010000010001001000000100011010000001000000000000000000001010000001000010010010100010111
00001000001000000100000000000000000110001011000000000000000001000000000000000000000100010000000010100
00001001000000010010100000000100000000000100000000000001000000100001001000000100100100000000100000000
00000000010000000010000100000000100000001000001010000111000000000100001100000001000000101100000001010
00000100000000000000001001000000000000000000000010010000011001000000011010100000000100000000001000000
00000000100000000100100000100000000100001100001010000010010110001010000000000000000000100001100001000
