00000000000100000100000000010011000000000000010000000000100000000000000110001000000000000000001000000
10010000010000000100011000000000000000001001010110000110000000000011010011000100000010001001010000010
10010001000100010100000000000001000000000100000011000000000000110000000000010000010000010100000010000
00100000101000011000000000000000000000000001000001000000000001000010001000000000001000000000000010100
00000000000001000100010100000000000000000000000010000000000000010000100011000000110000110000000000001
00010000000000000000001000000001000100001000000000000000001000000010001011000000000000010000010001001
00110000000000000000101000001100000101000100000010010000000000000110000100000001010100000000001001000
00000001001011000000001000000000001011110000000110000000100000010010010000011001000001000010000000000
00000000000000000000000000100100100000101010000000010000000010000000000000010000001010000010101101001
00000011000000000100010000110000000000000000011000011000000000000000000011100100100100000001001000000
00010100001111000000000100000000000100000001001000001000101000000000000000000100010001000000001010000
00000000100010001011000000000000001000000000000100000100001000110100000000000010101100000000100010001
00000100000000000000101000000101100001000000000000000101100000000110000100010000000001010000001001100
00001000000000001000000000000001000100000100010000000001001000001010010000000000010000010000100000000
00010001010001000000000000001000010000001000001100010001110000010000000001000100001000000000000000000
00010001000010001100000010000001010000000000010001010100000101000000001000000000010001000000000001101
00000000000000000000111100000000011000000010000000110110100000000101010001100100000000011010000000000
00000000000000000000000100000000100000000000010010100100000010100001000000000100000111110000010000010
00000000010000001000000000001000001000000001100001100000000100101111000000000101100101001000000001001
00100010000000000000000100000001000001100000000000001001010000000010000000000000010100000000000000100
10010101100010011000000100000100000110000000000000100000000000100000000000000000010000000000001100000
00000000000000001000000000000010000100000000100000011010010000100000000001100101000000001001010000101
01001100000100001000001011101000000010000000100000001000000000000111000100000000001010000000011010000
01000010100000000000000000010000000000100001010110001001001000000000010010000000000010000000000010000
01000000010010000001011010000001100000010000000000100001000101000000001000000101110100100000000001000
00000000000000000100100000000000100011000000001010000100000000000000010010100000000000000000000000001
01000000100010000000100110001010000010101000000100010010000000100000000000000000100000100011000000000
00100101000010010000010000000010000000000010000100000000100010000000001000000000100010100000101000000
00000000000001000000000000110000100001100000100000000000000110000000000000000001000000100000001000100
00000000000000000000001000000010000000100100000000000000000000000000000000000000000000000100000000000
10000000100001000000000000000000000000110000000000011001000010000100110000010100011000000000101010000
00011101000000000000000010000010100000000000000000010000100000011000001010000010000101000000000000000
10000000000010101100001000000000000000000000000010100000010000011010010001000000100000001011000011000
00001001000000001000001000000001000101000110010000001000010001100001000000000001010100000000000001000
00010000000000000000011000001010100000000000000000000000000001000000101010000000001000000001000000000
00000001000100000010000000000000000000000000001000000010000000101010000001100000000000010000000000000
00010101010000100000001100001000000000000001000010000000000001001010000000100000100000001100100100100
10010000000001100000100000000001101000000010000000000000000110010001100000000000001000000001000011000
00000000010001000000000000000000100000100000000000000001100000010000111001001000010010000100000000100
10101000000110010010000000010001000000001000000000000000010000000011010000000000001100100000000010000
00000000000001000000000000100010000000010000001110000000000010010000000010000001000000011010000100000
00000001000000011000000000001000000101001000000100001100000000000100000001001000000010100101000000000
00010001000000000000000000000000000000000000000000100000100111000100000000000100010000000000001000000
10010010000111001000000000000000100100000001000000000010010000000100100000000000101000100100000000010
10000010000101000000000000000001001000000101000000100000000010010110001111000000010000000001101010100
00110001111000100100001101000001000100111110000001100000100000000000100000000000000001010000010110010
00000000000000000111000000010000000000101110010000001100000001000000000000000000000000010000001001011
00000000100110100000100100000000010000000101000000000001000000001000001001000001000000001000010000000
00000110001100000000010000001100000010000000010000000000000000110000001001010100000000001000100100000
00100000010000100010000000001000101000000100000110110000100000110101000000000010010100100000000011000
00000000100000100000001101100100000001000101010000000000101000101000000000001001000000000000100100001
10000000000000010010011000001000011100000000101001000000000000000000100000000000100001001000000100100
00110000000100010001000000000000110001010101010000101000000000010001110000000000001000110000000000100
00000000001000000101000010011101000000010000000000000000101010000000000000000001000100000001000001011
00000000000000000000000000100101000000001000000100000000111000000000101110110000011001000001001000100
00110000000010000100000000000000001100000000000000100000010001100000100000000000000000100000100100000
10100000101000001000000000100000000000100000010001010000000101000000101001000000000000000100000000000
00000000100000001000000000000100010000001011010100001000000010011111010001100100010010001000010100000
00010000101010010000001000100000000000000000100000011000000000000001000000000000000100010000000011000
00000000000000001000001001001000000100110100000000000000000000000101000101000000000000000011011010100
00000001101000000010000000000000000100010000000000110000011000010000100010000000000000000010000000000
00000001000000100000010001000001000000000011100000000000100000100001010000000000100001000001000000000
00000000010001000010001001000000001000100000010001000100000000010001100100110010000000000001000110100
00110100000000001100000000100000100010110000000000001000000000000000000110010010010000000010000000100
00000000001010000000000100100000000000000011001000100101000001011000100100010000000011000010010000010
00100101100000000000000000001000000001000100000000011000100100000100001001001000000000110000001100100
00001100010000111000000000000000101000000101000000101000000001010000000000000000001100000000000000101
01011001000010010010000000001101000000000000001001110000000010000000000000010000000000000000000000000
00100110000000000100100010000110001000000010000000000000000000000001000100010100010000100001100000000
10000000000000100101010100000010000010010000011100000001000001100001000100000000000000000000000001001
00000000001010100100011001100001000100011010000000000010000000000001001000100000000001000001100000000
00000000010000001100101000101010111010000010000000000111000011010001000000000001000000000000000000001
01000000000100000000000101100000000000001000100000000001000000000000010000100000000110000010000001000
00000000000000000001010010010000100000000100000011010000001000000101000000100100010001101010100011000
11001000000011100000100000001001010000100000000000000010001001010001000110001000100000000000001000001
01000000100010010000000000000100110000010100100001000000000000000000100000001001010100000010000001001
01000000000101000000000000000101000000000001100000100010100010000000010000001110000000000010100000000
10001000000000000100000000000000000010100001010100000000010000000000101000000000001000100000001001001
10010000000000000001000100000000000000000010000101000110001000101011000001000000011010001110001010001
00100000000010000010000000100000010000000001000000000000000000000010000000000000100110011000001100100
00100010000000101100000000000000000110000010100000010000000000011000100000000000000001100100010010000
00100100100000000000001100001000111000101000000000010001000001000000001010000000000110000001000001000
00001011010010000000000000000000000010001000010000001000000010100101000010000000000000000100000000000
00000010001101000100001000010010010100000000000010000011000010000000000011000010100000001000000010000
10000000001001001000010001000000000000001000000001000001000001100010010000110100100110000000000000100
10000010100100100000100001000001000000000000000000000000001000011000000010100010000001000000001010000
00000000001000000000001100000000000000000010000000000110100000100100001000010001000001000100000000101
01000000000001000001000100000000000000100001000000000000000000000000100000110000011100010100010011000
00001000010000000001001000000000000000000001000110001000111000011110011001101000100011001000000000000
00000100000000000000000100000000010010001000010010100000000001001000001000000001000000000000110101001
00110000000100100000000000000100010011000000000000100000000001001000000000000001100010000010000100101
00010000000001000001101000000010000110000000100001100000000010001000000010000100010000000000000000110
00000000000000101000010000000000000101000000001000001000100010000010110100000000000110000000000010000
01000110001001000100000000100001000000010100000000000011000010000000001111100001010100000000001000010
00110000100000100000000000000000010000100000100110000101010010000100000000000001001111000000000000000
00100010000000000000000000110100010000000000000000011100000000000000010110000000000010010000000000001
00010011000000010000000000100100000000000000000100000000000000000000010010011001001101000000001000100
01010010000000000000010000000000000000001001000000001000000000000011000001000000000010100011000010000
00000010000000001000010000010000100000000100000101000000000000001000001000000000001000100011100000110
00000000000001100000000000000001000000000101000000100100000000000000100000000000110100000101100000010
00000000000000010000001100000000010000000000000100000101100000000000000000001100000100000010011000000
