00000000000100000000000000100000001000010000000100010000010101100000001000011000000000000101010101100
00000000000000101101000000001000000000000010000010000000110000000000000010001000000010100000101000000
00000100000100000100000001100000000000000010010000000000000001000100001000001000011000000001000000000
00000000100000000100000000001000000001000000010000000000000000000100011000000000000010010100101000100
00000000000000000010000110001000010010000010100100000000000000010000000011000000001110010000010001000
11000000010010010100000010011000000000010110000000100000010101000001001100000000011001010001000000000
10001000000000100000010000000000000100100001000000110000010101000000101101000000000010001000000011101
00001000000000011110000100000001000000000000000000101000000010010100100000000101000000100000100000010
00000011000010011000001000001000000000000010000000010000010111000000000001000000000010000001001000000
10000010000000100000000110100000000010000100000011001000100001000000000100000000100100001000000010000
00100010001010001010000000100000100001000000100010000010110010010100000000000100000000000110000000000
00010011000000000101010010001100000100000001000010100101100000000001000100010000100000100010000000100
01000001100000000011110001000000000000000000101100000000100000010001100000010101000000001000100000010
10000001010100000000000000000000100001000010011000010000000000000000000001000100000000000000000000000
00000110110010000000011010000010000001100000000000010010010000010000001100000000100000000000000000101
00000000000000010000001000100000000000000000100000000100000000011001001000010100000100000100110000101
00001100000100010000100010000000000000000100000010000000000000100000000100010000010000000000000010010
10000011101100000000010100000000000001000000000010000010000000000000001001001000100100001000100000000
01000000110100000000101000100001000000001001010000000001001000000001100000100000000000000000000000000
00000100000001000100100000011010001000000000100100100101000001001000001000100010001000010100101000010
11000000000000010001000010000001000000000010000000001000000010110100000000100000000000000000001101000
00100000000000000000000011001000000000010100000000000001000000001101000001000011000100000000000000000
00011000000000000001000010010100000000000100010000001000011000000000100001010001010000100000100100000
00000010010000001001000000010001001000000000000101000100000001001000010001011100001000000000000101000
01000000000010000100000000001000011000000000000000000000000001000110100000010001001000000000101000000
01000000000000010010010000000001100001001001000000100100010000010100000010010001010010010000000000000
00010000000000000000100000000000000000000000000000000101000100000101000111000000000000010000101000001
00000000000001000000010000000000000001000000010000000000010000000000000000000000100000000001001000000
10000000000001000000000000010010000000001000000010000000000010000100000000000000000001000100000000001
10000000000000010110001001000010000001000100001010000011000001000000010000001100000000101010001010100
00101000010000000000000001010010000010000001100000000100000000000000100001000000000010010000001000000
10000000000001000010011001000010000101010100100000000001000000000110010010000000101000010001000010001
00000000000100000100000100000010010000001010000000001000000001000000010001110000001000101000010100000
00000001000011100010000000000000011000000000000000000000010001000010100000100000000000000100100000000
10011000000001000000000000000000000000000010010000000000100001001000000000000001000001000000101000100
00100000001000000001000000001010100000000100001000000000001110010100000000000001000100000000000100000
00000010000010000010000000010010000001100000000000000000001100000000000001000110011000000100000000000
10101000010000000000100000000000000100000000100010101100000000100000000000100100000001000000000000000
00000010010000000100000000001010000000001000000010001000000000101100000010000000000000000010001000100
00000000000000000010010010101000000000000000001000000000100000000000000000100000000011011000000100001
11100000000001000000001000001000000000000000001001000010000010000001010101000000000000011000011011000
00000001000000000100000000010000000000001000101000000000000000100010000010000000010100000010001001000
00010001010000000000000001010000000000010000000010000000101000100000010000001010110100101100100000011
01110000001001001000111000001000000001000001000100100000010001000000001000000010000100000000000010011
00000000000001000000000000000001000001100000000000001101010000001000000100101000001000100110000000000
01001010000000000000100000000000000000000000000010000000000000011000110001000000101000000000011010000
00000000000000100010000100000001011010000000000100000000000000110000010000011010001000000000000001000
00000010000000010001001000000000110000000000000000000000000000010000100011001000000100000000000001000
00000100000000000000101000101000010000000001000100000001101111010000001010110000000001001000010110000
10100001000100000010000001100000011000001000000100000000110000110010000100001000010000001001000000001
11001110000010100010000000000100001011000000001000101000000100000010111100000000001010001001111001001
01100001011000000010000001000000100001100000000000100000000001000101100000010000001000000010110000001
00100000100001011101000000000110001000000010010000000000000100100000000010000100000000000000010000001
00000000000000101001001010100001010000000000000000000000000000000000000100001000000000011110000010000
00000000000110110100000000000100001000100101000000000000000000001000000001000000000000000011100100100
00100100000100000001000010011000000000000000011001011000000000000000000000000001100000000100000000010
00000001010000000000101001010010100010001000001000000010000000000101000000000010001000000000101000000
00010010011001110000000000000000011000000000000001100100010000110001010000000100000001000001001000100
00000011100000000000000100000000000000000010000000000000110001000011010000100100010100000010100000011
00100000000000010000100001000001000000000010000000000000000010000000001000000100000100110000000000010
00001000001000010000000000001000000000000100000011000000010000010000000000010000000010110000010001111
01010010001001100000000000000001000000010000000000101100010000010100001010000000100000000001000100000
00001000000000000000001001000000000000000010011010000010000010010000010001000000001001000000000110001
00000000001100010000000000000000000011000101000010000001100100001000000000010000000000100000010000000
01101000100010000100000000001011000001010001001000000010001000000100001000000000000011000100000010000
00010100000000010101000000100000110100100010000000000000000100100111110000000101000010010010000000010
00011000100100110000000000000000000000000000000010001010001001000100001001000010000100000010010000010
10100010000001110010001000001001000010000000101000000000000000000000000100010100010000100000010010001
10000000100010010000000011010001000001010000000101110100001000000000000100000000010000000100010000000
00001000010001001000101010011000001000000000000000001000001100000000000001000001000000110000100000000
00000100000000000000100000000000000001000000100000000001001000000000000010001010000000101010000000010
10000000001000000000100000000110000001000001001000010000100000111000000010001100010000000011101100000
00110000001000100100000100001000000001010111010001000000001001000001000010000011110001000000000000000
00000010000000000000000010000011000000000110100000000100000100000000011100000001000101011000100010000
00100000001001001000000000000000000011100000001000000000000000011000001000000000110010000010010000000
00000000000100001000100001001010011000010000010110000010000000010011000000001000010101010000000110000
00011010011001000010111000000000001000000100001000000000000000000100110010001110100000000001000010111
10011000000000000000000000000011000010000110000000000000100001000000000000000000000110110000000000000
00000010001000001010000000001000000000000000000000001001000000100010000010000000100000110010010000000
00010000000000001010000100101000100010000100000000000011010000000010001000100010110000000000000001110
00000000000010000110000000000100000011110000000000000000000000100110000000000010000000001000010100000
00010000001100001001001001000101001000001001011000000010001100001000000100000000000001000101000010000
00000000000000000000010000000001010000000001100001000000000000010001000100001010110000010001001001010
00000000010000000000000010000000011000000000010100000000000001100000010000100000000100010011000000000
01100000011010000000010100010000100000000000001000000000010101000001000100000010010001000000000101000
00000000001000000000000000010100001001000000000000000001001100010000000010001000000010000000000000010
00010011000000100100100000100001000010100101000000000000100100101100000001010011000010010000001000001
10110010000000000101010001000101100001001000100011100000010010000010000010000001010001010000001001000
00000001010000100100010000000001000111000100100100011000010100000001010000000100000000100000000010000
00000000100000100100000100000000000000000100000010000011100100100001000001000000010100100000010100000
01100100100000001000000010000001000000000000000010101101000000000110000000001000010011000000000000000
00000000000001000010001100000000000000000100001100001000001001000010101000001000000000000011100000000
10000000000100001100000000000010001010000000100011010001000101000010000000000110110000000000001100000
01000000100010100100000010000001000000000010000000000100100000000000000001100000010100010000000000000
10000000011000011100001000000000000000101010000000000001000000010001001000000001110000010000001000000
01101010000000100100000000000010000000001101000100010000000100000010001000000100001010000000010000000
00100000001000000011000000000010100000011101101101010000000000001000000101000000001000000010000000011
00000010100010001010010000000011010000011000000100110001101000110101000000000001010000110101101110000
00000011000000000000100000000000100000000010000000000100001000101000000000100000000000000011000101000
11000000000000000001000001000010000000000001100000000000000000000000000001010000000010000000000001010
00001010100000010001001101000010000000000000000000000000000010001000000011001000000111000000000000000
