00010000000011000001000000010000010010001000000000010010100000000000000100100100100010010100000101001
01000000000000000010000000100000000000000100000000001000000100000000000100000101000001000100000000000
11101110000110001000000000100100010000110001000000100000000010000000010100000011001000011000000000010
00000100000011101100000000000001001100000100100000000000101010010000000000000000110100000000100000000
00000001001100000000100000100000000000010000000000011100000001100000000000100100001000010000000100011
00000011100001000000001000000000000001001010000100000000100001000000000000110100010000011000000110110
00100000001000000000000010000000001001010100000000010000010000101000000000001110000010001111000000010
00000000100000000100001101000000011000100000000001000100000000010000000000010000100010001001010011010
00000000010000010001000000010000001001000000000000010001000000000010000010100000011000110000000000010
10000010001000000001000100100001011000000000001010100000100000010011000111100000000000001100000010000
01010101000100000000111000000100010010100100010100100010000010000010100000000000000001000100001010000
00000000001100010000000010100000000000000000000010100010001101000011001000010000000000001000000000000
00001100101001100000000000001010010000000101000000000000101001100100000100000000000000000000110100101
00000010100000100101100001000000000000000000000000101100000000100000100000001001111000000010100110001
00000110000001000000000001000000000100010010000000000000001000000000000110000001011000010110001000000
10001100000000000000000000000000100001010000000000000000000000000100110000000000000000000000000000001
00010000000000000000000010001001000000010001000000110000000000000000010010000010100101100000000010000
00000001000000000100000000001000001100000101001000000001001101000010000001000010001001100011010010010
01000000010000000001000000100001100001001000000000000100101010100001000010001000000010010000000010000
01000000000011100101000000000000001000100010000001000000100001000100000000000010000011000000010000100
00101000000010100100000100000100010000000110000000110000010010000100000001001010000000010000000000010
00110000000011100001100000001001000110001000000000011000000001000100010010000000010000010000000000000
00010100000000101000001100000000110101010001010000000001100100110100000000000000100000100001110101010
00100000010010000000011000001000001100011000100100000010011000010001001000000000000100000100100000000
00001000000000001000000000001001000000000000001100011101000000001000001100000000100100010010000010010
00000010000000010100100110000100000110000011000100000000100011000010010001000000010000000000000000100
00000000101000000000110000000000000100000000000010010000010101001011010000000110100000000000000000000
00000000000010000000010000010000100000000110000000110000001010000000001001001100000100001000000000000
00000100010000010001000000100000000000100100010000010000000000010011000000100000000000000000100000000
00001000000000000000000101000010110000001000000100011000000000010001000111000001111100001000001100001
00101010000100000010100110010010000000101000100100011100000000100000000000000000101000000000000000001
00001100101011000010000001000100100001000010000100001000010000001111001000000000100001001001000000101
00000000100000011000000100100000001100000000111001000000001000000100000100000010000010100000000000000
00000000000100000000001000000000000000100010000000010011010000001010000000000000011000001000000100000
01000000010100000000000010000000000000011000110011001000000010100000000101000000100001000000000000000
01100000100000010000010000001000011000000000000000000000000000000000011000000011000000010010000000010
00100000000100000011000000000000011100000001001100100000000000001000100110000111010010100100000100001
00000010100001000000000000011010000000000000010000001001001100001100000000100000001000000000000000000
11000100100000000000001101100100000000000000000000011000110000000000000000011000101010100010000000000
00000000000100000010100000101001010101000000000000000000100000000010000000000100010000000100000000110
00101000000001000000100000000100000000000100000010001000000000000000010000100000101010100000010010001
00000000000110000001000000100010110000010000000100100001000010100000000100101000001001110000001000000
00011000001110010000000000010000000000000010000000101000000000000100000000000000000000000001000000000
00000000100000000100010000100010000000000000100000001100010010000000000000110000100000100000011000110
00100101000110001001000000001000100000010000000100000001000010010000010000000000010001010001000000000
00001000000000010000000101000001000010101000010000011000000100000011000001010100000100000000000000000
00010000010000001000000110010000000000011100000011000000000000000000011010010000010000000000010000000
00000000100100010001100000000000010110000000000000000000100000000000000000000000000010000100000000000
00000000010000001010101000010001000001000001000110000100010001000001000000000000010110000100100000000
00000101010000000101010000010000010000000101010000000000001100001000001100100000001000000000000000010
01111000000000000000001000101100100011001000100110000001100000100011000000000001000010110000000100100
01100000000001010001000000000000101000010101100000000010000100000101000010001000001001000000001000100
00001010001000000011000000100000000001000010000000110001100000000001000001000000000000000000100100001
00111000000000000001001000110000010100000100100000000000100100000000001000000000011000001000000100100
01010000000000000000100000000001000000000000000000001100000001000000110001001000000000000100000000000
00010000000100000000100000010010000001000100110000000000000010000110001100000001101000001000000000010
10000000000110000011000000001100000010010001010000000010100000001000000001010100011000000000000001101
10001100001000101001011100000000010000000010010001000000000000100010010000000000001101001000000011000
00000100000000000000010000001001101010000000000010001000110000000001000000000001000010110001000001000
00000100000000000010000000000001000000110001010100000100000000010100100010000000000001001000110101000
00000000100000101001000000011010001000000010010000100000010000000001000000101000000100000100000000010
00001000000010000001000100100001000001001100100001000111000010000000000000101010000100010010000000001
00000000000000000101001000000010100000000100000000000000100000110001000010000010000010000000000101000
00000100000000010000000000000001000100000000000100000010000000100000001001010000000010010100000000000
00000000000000100001100001001000000100100000000001000000000010100000000011010000010001000000001000000
10000000010000000000100001000011110010000000000010000000010100100000010000000000000100010000000001100
00001000010001000000001001000000000000000101000110100000000000000001010001000000100000000010000000000
00000000010000000000000000101000011110001000000000000000100000000000000001000001000000001000000000011
00100001000100101000000010100100000110010011000000000000010000000000000001100000101000000000010001001
00000000000001001000001000010001001000010000000001001000100000000000000100100001100100001000001011000
00001000000000100100010110000100000100011000010100000000110100000010000000000000000001010010001001000
01000100100001100000000000000101000010010000010000100000000001000000001000101000100010010000000000000
00000010001010000001010000000000000000000100000101000000000100100000000001000001001100000000000010000
01000000010101000100001100000000011001010000110000000000100101000100110000000010100001000000000010100
00000000000100010001111100000100000010100000000100110000000000000010010000000001101100000010010000000
00000010101100000000000101010000000000000100100010010000010100011000001011000110000001100000000000000
00001000000110000000000010100000000000000001010000000000000001000111100000000000000000100001100111000
01010001011000000010110000000000000000000011011000100001000000000000000100000110010000000000111000000
00010000000001000000000000000110100010000110010001100010000000100000001000000010001000000000100000100
00000100000000010000100100100000100100010000000000000011000000000110010100010000000001001001000001000
10000000000010100000100000100100100010000000010000010100101101000010000010101001000000000000000000000
00000011010001101000001000000011000000101000000000100000000000001000001001001010000000000110000100000
00100100000100000000100000000000001010000001000100000000000001000001001000000000001001000000000100010
00000001000100000000000000000000000100000000100000000010000000000000100100100000001010010000110100000
00010010000100000001100010100010010010010000001000000000000001000000000000000100001001110000010110010
00000010000000011010001101000001100000000000110000000000100100000000000000000010010100001000000000000
00000000010000000001100000000000010010000000001000000000001000011001010011000000000010001000001000010
00000000010000100000010000010000000000010110000100010000000000000000001000000001000000011010000001000
00110000000010000000000000001000000010000100110111110010000010001100000010100000000000010101001100101
00100000001011000000000100000100000000000000010001000100100100000101000001000000001010000000100000000
00000000100100100000100000000000000000000010000000010101001000000000000000000000010000000001001010010
10010000000000000000000000000000101000010110011000000100001010000100001000001000000000000000000000010
00000000000010000000000100100010000000000000001001010000000101000010000000000110000000101010100000000
00000000000001000001100000000011010001001011000000000001000000000000100100000000001010010000000001000
00101000000000001000000000110000100110000000000000011000010001001101000000000000000000000001000100000
00001010000100011000010000000100000010000000001001100010000000000101100000000101001100000010000001000
00000100010000000011010100000000000000001000000000001000010000000001000000000000000100000000001000000
10000100100000000000010000010001000010000010000001000010000000010000000000001010010001010010000000000
00001000000100000000000000000000000000000000000001000000001100000000101000000110100110011000100000001
10110010001011000001100000001001010000011000110011010000001100001000000011010000001000010000000010000
00001000001010000000010100000100000001000100110001000001010000101010100000000000000000010000000000000
