00000000110000010011000100000010100000000000010100001001000010000000000011100000101110000000100000101
00000001000000000000000110000010000000000100000000000110101000011000001000001000000000000001000000001
00100000010000000000010000000000000001001011000001000000010000100000010000010010110000000000100000000
01010000100000000110000000000011001000010110000000010000100000010000010000000000001000000000000000000
01000010001100010110001001000000000000100000000001001000010000101000001001000010000000011000000000000
00000100100000010000000000000001100001000000001001000000100101100001001100010000000000000111101000100
10100000000101000000000110000001101101100000001100000000000010000000000000000000000000000010000000000
00000000010000000000010000001110100010001001100000000110000000000001011001000011000001000101000100001
10100010100000000110010010010001100001111010000100100001000000000100100000100100000000110100010000000
00011001001011000001000000101100000100001000000011010001000000100000101000000000000010000000000000000
00001000000001100000000000000010001101010000100000001000000000100001100010000000000000000100101000000
01010010001010001000010001000000100000100000000011000000000000000000001100000100010001000000000000000
00000000000010100000000000100010000010000000010000001000000000000000011000010000000010000000000001001
00000000001000000001000101010110000000000000000010000000000000111000000100101110000001000010010000000
00010000001100100000100010000001100000000010100000001001000000000011010000101100000010011100000100010
10001010010001000100000000001110000000010000001000000000000000010000000100010001000000010000000010000
00001101000010000101100010000110000000010000100100000000011000000000000000000001000001001000000100000
00000110001010010000001000010001010100000000000100000000010000000000001000000100000101111000000000000
10000000000000000001010000010000000100000100010010100000010100000000000000000000001000000000000000000
00010000000001000001001000000000101000001000000000011000000000001101000101000100000000001000000001000
00000001000000001100000011000000100000001011010000001000000000000010000000000110100010000000000000000
00000001000010010100110001001100001100000101000000100001100010000000101000110000000000011001000000000
00000001000000000010000000000001000000000000000000100000010001100111001000101000010000001000001010000
00000000000010000000000000000000000000100001010000001000010000000000000000010000000000000100000000000
00001000100000100000101000000000000000100000000100001000000000100000000000001000010100000000000000000
11100000001001010000000000110000000100000100100100000000100000010000100000000000010100000000100001101
00000000001000000000000000110100010000000000010000000000100000000000100000011001000001000000000000000
00001010000000000110010000000000010000000000000000010000000100000001001101001000100011010001000000000
01000000000000010100100001000000000100000000000000000001000000010100001001100000000100010001000010101
00010100000000000100000000000010000000000010001000010010000100011010000000001001000000000010001001001
00000000000000000101000110110001000000100000100001011000000100000000000000000001110000100000000000011
10000000000000000000000000100100111000000000000001000000011000010000101000100000000000000000001100000
00000000000001000100000001010000000001001001100001000000000000001000100000000000001001000000010001001
00001000010100000000110000001000100000000011000000000000110000000001000000001000000000000010000000000
00000001000000001000010000000000000110100001001010000101000000000010001000100000011000111000010101010
01000101010010001000001100001000000100000000011001000000000010010000000100100000010000000100110010100
00000000000001001000101000001001000000000000010000001100000000000000001000100001000000000000010001000
10000000001001100000000010010000001100101000010001000101000010100100101000001001000001100101000001000
00001000001101100000000000000000000000000010000100100001100100010000000010000001001001010001000000000
10011000000011000000010001011100010010000000100000000000000000100000100000000000001100000000010000000
00001000000000000000011000100000000000000000000010000000000000000000001001000001000110101000000000110
10010011000100000101000001000000110001000000111000000101100010011010100000000010001000000111000000001
10000000000000000001000000000011100000100001000000000000101000000000000010000010100101000001000100100
00000000010000000010000101001000000010100000001101110001001010000000000111010000100000000100000000000
00010000000100100100000000000010000000100010010100000000000000000000000000101000110001000100001000000
01000000001001000010000000000010000000000100100001000100000100001100000001001000000010010000000001010
00000000000010100001000000000000011010010000010000000000001000011000000000010001010000000000100000100
00010001000010001000001000000000000010000000010100010000000000100000000010001000100000100000000001010
01000000000000011101000001100101100000001100010000000101000100111000011000000100000001000000000000000
00001000000000001100100100000000010000101010100000000010011000000000000000010010100000011000001000000
00000000000000000000010000001000000000100000000000001000100000000000100000100000010000000000000000000
00001000100100100000000000000110000110111000010011000000001000000010100001000000000000001010110000001
01000000000000000000100000000000010100000010000101010100000100000100000000010010000000000110000000000
00000000010000010000000001000110010001000001100000000100011001100010100000000000100000000010000100000
00010010000010100000100001100000001000000000000000011100000100010000000000000000010100000000000001000
00000010000000010011001001000001000000000000000100000100000000010001101001000010000000000010001100000
11100000001001000000011000010101000011100000000010001000000000010001001100100001000010001001001110001
00001101000101100000000101001100000000010000010000000001100000100100000001000100000000101001010011000
01000000011000101000000100000010000000100100100000000000000101000100000010100000010001000000000000010
00000010001000000000010001000100000001010000010100000000100000000000000000110010000000100000000100000
00000001000101010001010000000000001000001001000000001101001000100000001100100110100001000000100000000
00000001010000000000000000000000000000001001100000000100000001000000000000010100010000000011000010011
00000011100010000001000100000011000000000010100010000010101000010000000010000001100100010100100000100
00000001000000000001000000100000100000000000110010000000000000000001000000011000010000100001000100000
00000000000100010001000000100000000000000100000000000000011000111001000100010000000000000000000000100
01001010000000101000110000010000000000000000000000010010001100000000110000000100100000000000000000001
01000000001000000001010000110010000000100000000000100100001000101000010000000000010000010000001010010
00010101000000000001000000000000000000000010000000100000111010000000000100001000001000000001000010001
01000010000000000001000110001110000001100100000010010000000000000100000000000000100100000101000001100
00000001000000111000010011010001010000000001000000100000010000000100101000000010000010000000010000000
01010001000001010001001000001000000001000000000000000001000000010000110100000001000110000000001100000
00000000010010010010000000111000000100000000000010000000011000010000000000000001100000111000000000110
11010000101101110000010000000001100110110000001000000000100001000000010000000000010100000100000000000
00100000100101000000000010000000000000000000010000110001010000110000000001000100110000011010001010000
01010100100000101000001000000001001000100001000000000100000010000000010110100100000000011000000000000
00001010010001000101001110001001101000100000000000000010000010100000001001001001010000000000100001000
00010000000100100100001010010000000000101010000000001100000100010000100000000001001101110000100000011
00100010110101000100000000000011001000100010000001011000000001010010100000100101010000000001001001000
01000000100000000000110000000000101000100010100000000101000010010010000000000001110100000001000000000
00100001000010001001111000100100000001010000110100000100010100010000000000000000000100100100000000000
00001000000101000001000000000000000000110000011011000010000010000000010000000100001011000000100000000
10110010000000010100101101100000100000000000010000000010010000001100000000010000000000100000011000000
00100001011000001011001000011100000100001000000010100010010001000000011001000000000000000000001000000
11011001000001000000010000010000110001010000000000000100000001001100000010000001001010100110000000100
10000000100000001000000000001000100101000001001000101000001000000000100010001000001100000010100000000
00010000001000001010001001000000000000000000000100100101000000000011001000001001000000000011000000001
00100100000010000000000000001010100001100000100001000000001000000000000000010010000000010100000010100
00100000000001101000000001000000000000010000100000001010000001000000010000000000000011100010010000010
00100100011000101001000000100001010000000000001000000001000100000000000000100000100001101001000010000
00000000001010000110000000100100000001000000000001000000001000000100000000100000100010100101100100111
10000100000000101010000010100000010000000001010000010010000000000000000000000100000000000100000000010
00000000000010100001000001000011000000011000000000000000000000000100000000000100000001010000000100100
00100000000000011001000000000000100000010000000110010010000110000000001000011000001000001000100000000
00000000100001000000001010100000100000000101001100001001000010000010100100000000001000010010000010000
10000000001001000000001100000000110010000000100000000001000000010100000000001010110010000000000000100
00000001000101000010010000000000000100000000010001001000000000000100000011000000001010000010100000000
00000000001000000000000010010010000100001000001110000000000000000000010100100000000010001000000001000
00000100010001001101000000000010100000000001000000000000010000101001000001000000100001000001000000010
10001000000000010100000100000000100101100000000010000110100000000110100001000000110000000100000010000
00001001010001010000000001000000000000000000000000000010000000000010000000000100000000111000000001000
00000100001000100000100100000001111000000100010000000100010000100000000100000100100011110000000010010
