00000000000010000000000000000010000001010000011000010110000001011001000011000000000000000010010000100
00001000000001000100000000100100000010000000010000000000000000110000000000100000101101100010100000000
00101000000000000010001000000000000010000001000000000100010010011000000000011000000010010000001100100
10010000000000000000110010010100001010000000000000000000000000011100000010000001000101001000000000010
10000011010000000000000000101011000000001000000000000100010010000100001001001100010100000001000010000
00000001000001000000000010000001101101000000001000000000110000000000010000010000000011000000011000000
00100010100000100000101100010000000101000000001000110001000111000000100010001000000001000000000101000
00000000010010100010010000000001001001011001000000010110010000000000100000000100011100000000101100000
01000000000001000000010000010100100011101010001000101110000000100000000000100000100000001010000100000
00010000001000000000100000001000000000000000000010000000010100000000000010000000000000000010001000000
00000010000110010000100000010000000000000100100100000000000000100000001000000000000000100100001000000
00001010001000010000011000001100000000000010100010000100000100000000001000010100000000101000000000011
00001010000000001000010100000000000000101000000000000010110010000000000010000000000110000111010000000
01000000100000000000000000000000010010000000100011100000000100001001000000000100000000011000010000100
00000000010110000000000100000010000000000000100100000001000000000010000010001010010000000000010000000
00010000000000000001100000100000000010010101000001000011010000110011010000000001000001110000100000000
00001000000001000001001001000010000001100000000000000011010000001000010111011100000101000000000001000
01000010100000000000001000000000000000000010111001100000001100000000000010010010001010000001000000000
10000000000001011001101011010000000001101000000000000010000000000100100101000000000000100100000000010
00001000000100000010100000000001000100000000001010000010000100100000000000000000000010100101001010010
10010001000100000000000010000010101100000000100001000010000010000000001000000000011000100010010000010
00101000000000000010010000001000000000001000000000001000001000010011000000001010001001000000001011000
10000001001001000000000000000110111000000100001000010000001100000001000000001000000000001000011011000
00011000100010001000000001100000000100000000000100000000000000010100001101000000100000001000000000110
00011000001000000000101010001000010010010000000010000110000001001000000100010001000000010000000000010
00010000001000100000010000000000001000100001000000100000000010000000000100001001000110000000100000000
00000011001001000010000001000000010001101000000100100010000010101001101000100000000000000000000010000
00000100001100000100011110001010000000000000000000000000100000000000110000010000000000000000000000110
01000000000000000001100001000000000000010000010000001101000100010010000100000001110011000010000000110
00111000000000000011000000000110000000010000000000001000010100010000000001000000000100011001000000000
00010000000000000000010000011000100000000010000010000010000000010100000010000000000001000011100000000
00001001000000000000000000001000000011000100011110001011000000100000000001000010100100001010001000011
00000010000000001110000000000011000010001100000000001000011000000000000100000100010110000100000000000
01000100000010010000000010000000000001100100011110000100000100000000001010000001000010100001100011000
00011000000101000000000000100000010001000000110000010000000011000000011001000101000000100100010000110
10000000100010111100000010100010000000011000011100000000000001000000011000101110010000100001000100011
00000000100000100010000010100000100110010000000000001011000000100000011000000000100000010000001000001
00000010100100000111001000001000000001000000001000110100000010001100000010000000001000000000000001100
00100001001001001001000000010000010010010000000001000001100100000000000100000000010000000000000100100
00010000000000000000001101010000100110000110000100000100000001000000001001000000001100000010010000000
01000000000000100010000011000000010001110000010001000001000000000000000000000100000100000100000011100
00000001000001101010100100000001000001100000000000000001100000010010000000001000010000000000000000000
01000000000001000000001100000000001010000000001001010000000000000000010000101000010000100100100000000
00000001000100000001010001000101001000100001010001000000000100000111000000000000000000010000000011000
00001000010010000110000000000000010000000010010100010000000000000000001000000010000000000010000000000
10010000100000000000100100000100000000010001001000010001000000001010001001101010000000000000110000100
00000010000000000000100000100000000000000000000000010000100000000000000000000001100100000000000011000
00000010000001000001000110010010000101000100000000100000001001001000000000000000000000001101000001000
00000110010000000010001011000110000001110000001100001000000100100101000000100000000000000000000001011
00101000001001000001010000010100000001000100000000000010000001000001000001000000000000000000001001000
00000000001100000001010000000000000000000001010000001001000000010000100000000000110010000100100000011
00000000100000100000000100001010100010000010010000101010011000010000001000000000000000100000000010000
00010000000100000000000000000000000111100000001000010000000000100000000000010000101000001000000000000
01010100000001000000001100010000100000010000000000000000010110100000000000100000000010000000000010000
01000000000000100100000000000001000000010011001100000111000000110000001000100010000100000100010001000
00100000000000010000001000000000100000000000100000100011100000000001000000100000000010001101100000100
00010010010100110000000110000000000110000100000000111010010010010010000000010000000101000000000000000
00100100000000000000000000000000001001000000010000000000000100011000000010000000000101000000000000100
00010000001000010000110100000011001100000000001000100000110000000000100010010000000000000100101010000
00110100000011101000000100010000000000010000000000000010100010001000000010000001000000000001000000000
00100010101100000000001000001000100000000011000000010010000000000000000101000000000001001010100100000
00000011000000010010000000000000111000000101000100001000000000000100110010000000000011000000000000001
00110010100100000000000000110000000000000010010001000011000010000100000010000000000000000000000101000
00000000000000000010000000000000000000001000101000100000100010000000000000000010101000001000000000000
00000000000000001000000000000000101000000000010010000010000100010000101000000000100010000000000010001
00100000100000000000000100010010001110100000000100001000000101001001010011010011000000000000100000000
00000100000010100111000000010010001011001100000010001000100001100000000100000000000010100000100010000
00100100000000001010001000000000000000000100000000000010001001000010000000001000001011000000000010000
00001000000000000100001010000010000111000000000101000000000000011010000001010000000000000000001010100
00010000001000000000000110010000001100100101000000000000000000100000000000000000000100100010001001001
01001000001000000000010010101100000000000000001000101000000100000110001000001000000110000000101001100
00000001001101000001000111001000000000110011000001010000010001110000000000000000010000001011000001101
00000000000010000000001000001100001000011000010100000000100000000011000000001011000000000000000000100
00000000000100001001000100000100000000000100000001000010000001010000000000000000000000000001000000000
01000001000000000010000001000010000000000000000011000001000010000000000000110011000100000000000100000
00001000000000001001000000010000100000000100000010000010000000000100101100000000010100000001010100111
10001000000000010000000000000000000000000000000000010001000110000010000000001010011000100000101010100
10000000101001110010100000001100000000000001000100101000100010010000010000000000000000000100100000001
00100010100101000000000001010000100001000100001000001001001011000000000001000010000000110010010010011
00010010010000001100000000010100010100000000000000000000000100101000010100010000000000000110010000000
00101100010100000000000000000000000000000001110100000000010000000010011000000000001100101000000000010
00100000110000000000000101000000001000000000000000011001110000010000000010000000011000011110000000010
01000100000000100000010010011100000000000001000000000000000100010000000100100100101001000001101000101
00000100000111001000000000100000100000100000000010010000000100000000011000100010000000000010000000000
01000000000000000000000010000101001010000000001000000110001000000000001000000010100101000000000010010
00101010000010010000100000000000000000100001000000000000000000000000000010000000000000000011000100000
00010000000100011000000010010000000100000000000001000000000000111110000000000000000000100010000001100
10010010001100000000001000010000000010000100010010000000001010001000000110000100011010100100010000001
00000011000000000000100001000001000100010000100000000001000000000001100000000000000000000000000000001
01000000000100000000110000000010000011000010010010100000011000000110000100001001000010000010000010101
10000000000000000000000000111100000010101100000010000101001101001101100000010000000100000100000000000
00000011001001000010000000001100000000000000001000010000010000000000101000001000010000100000100110000
00001100000000000110000000010000000000011000000000000000000000000010000000000000000000000000011000001
01010000000001000000000001000010010011010000000000000000010000010000100001010001000000000000001011000
10000000000011100000011000000100100000000000000000000010011000100000000000000000001000000000000000100
00010000000010010001011000000000000100111000111000110000001000000010000001000001100010000001000000000
00001000000000001010000000000000100001000000000000000001010000000000001001000000000000000000001000001
00000010010000001010010010000000001011001010010000000010000010000011000000010010001100000110000010000
00000000000100010100011111000000000110101001000000000010000010010000100000000000000000000010010000000
00001001110000101100000000110000010100001000100010001000000000010000000000001000000000000100100001000
00010000000001010100000000000011000000010010000000000101000100000000100000001000001001001111000000000
