00100101000001010000010001000000100000100000000010001000000000000000010000000000100000100000000000010
00010000000010010000000000000100000000100000001100010010000010000000011000100010100010010010100100001
00111001000000000100110000011000000001010000000001110000001000000000101100000001110101000000010000000
00000000000001001010000000000000000000010100000001010000010000000111011000001000000000001001000000010
00000010000010100000010011001011000001000000100000100100001000100101000000100001011100010000001100001
00001000011000000000000001000010100000000000000010000000111000000000000010000100000100000010000010000
00010000100000100000001000111000101000000000000000000000010000001100000000000100000000000001011001000
00000100000100000000100100000000100000000001000110100000000000000000000000000001000000101010100000000
11001100000100010001100001001100000000010000000010011000000010000000000100100000000001011001011100000
10000000000000001000100000001000000001000010001010010100010000000100000000000000000000000000000000000
01010011000000000000100000000000000001001100010001100011000000000100001011001010010001000010010001010
00000000000010010000001010000000010000010001000010000000000000010001001100100001000100000000001001001
10000001000001001000000011010000000000010000000000000000100010000000000000001000000000000001000000010
00000000000000000100000011000000011000101100100100000100010000001000000000000000001010000110010000000
00000000101000000010100000000000000000000100000100000000000000000111010100000010000000010000001000111
10000000000100010000010001000000000000000000000000000000011000000000100010000000000100011010000000000
00011000001001011110100000000010000000001000100001000000110000000000101100001011000000001000010010010
11100000000000000100000011010000000100001000000000001010000000000101100110000000000000010000000000000
00000100100000000010000000000011010000100110100000001000100010000101011000110000100000000100000001001
00100010000000010000000010000010000000000001000000000000000000001100000001001000000000000000101010000
00000001000100110100000100000000000000100000001000000100000010000100000100010000000001000000000000000
11001100100000000110100000000110001001000000000001000000000000101000000000000001110000000000000000000
00001001000000000000000000000000001110100100100001000001000000000001000100000000011000000001010000000
00100000000000101110011000010100100010000010000000000000000000000001000100001000000010000000001000000
00000000000000000110100000001010010000000000100001011001001000000000010100000001000001110000110000010
00000010000101010000000001000100000000000001000000110011010000000001100000001000000000000101000000000
00000000000001010000000001001101010100001000001000100001001000110010001010000010000000010000000001000
00000000000000000011000000010000000110010000000011010110101010001000000100000100000010001000000110000
10000000010010000000100100001000000001000001010000000000000010101000000000001100000000000000000000000
00010011100000100000001100000100000100000100010000000000000000000000000010010000000000000100000000110
00000000001000000010011000010001000000010001000000000010000101100000001100000000011000000101100011000
00001010000000000000000000000000000000010001000001001000000100000001010100001000101010000100000101000
01000010000000000000000000010001000001000011000000000000100100011000000101000100110100000000001000101
00111000100000000001000000000000010010000011000000000011000000000010000011011110000000010100000000000
11110000000000000101001100000000000000100000101000001010000001000100000000000000001000001110000001000
00000000010000000001100000001000000000000000000000000000101010010001000100000000011100100000000000000
00010000100000010000010000100000000000000000000001010000000000000010000100000000000000100000000010000
01000000001000100001001000000000100101000000001001110000000101100100000000000000100000000000100010000
01010011000000000010000000000011010010000000000000001000010000000000000000000010001000010010000000111
01000100000000000000000001000101000100000000100000000001000001000000001000000000000000010001000000000
00000100000000010001000100000001000000010000000000001001000000000000110001010010000101000000000000000
00000000000000100011001000001000000000000100000010010000000000000000000000010100000001100000000000010
00000010100001000000110000000000000000100110000000000000000100001000100000111100000000000000110000100
00000101010000000110000000000010101000000000010000000000111000001000000000000100110000011001000000000
10100000000000000000001100010010001001010010000000000100000010000000000001010000100001000010000010000
00000100100000000011001110100010010010000010001000010010010000000001110010100000000000000000000000000
00001000000100000000101000000100000001000111000010100001000001000000100100000010000000000000000000000
11000000001000000110000010010000111010000001001000010000000110000001110001110100000001001000000110010
10100010001001100000000000000010000100000000100100000000011001000011000000000000000001000000000100010
00000000000000100011010100110000000000000100100101001000100000110000000010010100001000010000000000011
00100100100000001000000000000000011100000000000000000110010000000011011010000000000010000000000010001
00001011000010000000000010010000100000010001100010010000101000000001001000000110000001001100000000011
00000010000000000011000000000000000001000001100010000000000010100010000001000101001011000011010001000
10001100011000000010000000000100000010000000000000000000101001011010000000000010100001011000000100100
10000110000000000011000000000101000000000000011001000000110001000000000000100001100100000000000010000
00011010011000010000000010000000000101000000100000001100000000010100001000100000010000001010000000001
00111000000100000000000000011100001100000000000000100100000000010000000001100001000000000110110001000
00000000100010000000010000001101010000000001000100000000110100000000001000000000100000000000100000000
00000001001000000001000000000001110000000000000010010001000000010000111000010000000010010000110000000
00100010001000100001000000000100001000010000001011000011001000100000010001010000000000110100001000110
00000001001000011101001000000001000101010000000000110010000100000000001010000001000000000000100000001
00000000000001000000000010000111100000000010010000000000010000000000100000000010000100000000000000000
00000000000000000000010110000000000100001000000000000000010010011000000000010000001001010001100101001
10000101100000100010000010010000100000001010000000010001000000000100000010000100000001010001000001010
10110000100000000001001000000000000100001100000000110010000000010000100000000100000001010000000000000
11000001000100000000111011000010000001000100001100000000000011000100000100000000000001000000001000010
00001000001000010010000100010000000000010010101000010000000000000000000000001001000000100000100100001
10000100000001000000000000000011000000000000000000000000100010000000000000000000000000000101011000100
00000000000000100000100000101000001000100000000000000000010000000101110110011010001000000000000110000
00000000000000000010001101011000010000100000011000000000001100110000000100000000101000010011000000000
10110000000000000110000000000010100000010000011000000000001000000000101000000000101000111000000110000
01000100000000000101010010000000000000100001000010000000000010100000000100000000000001000001000001000
00100111000000000001000100000000000000000000000100010000001000100000010010000100000000000000010000000
00000100100000101000100000000000001000001000001000001100000101101001000000000000000101000000010000000
00000000001001100000000000000011000110001000011010010010100000000001100000000000000000100000001001101
11011000000000100000000000001010000000000000000010010100000000100000001100100010000000000000100100000
10001000000000000000000011000000000011001000000000000010000000000010000000000000010110000000001000000
00100100000100111000000100000100100000000000000110000011100010000100001000010001001001000000000000001
00000100010010000111001000000000010000000000000000000000001000000010000000101000000000100100000100000
00100000000000010010000000011000000001000000010100100010000001000000010000010000010001110000110001100
01000000010000010100000000000000000000000000101000000110000000010000010000010010100000000000100000100
00100000000100000100111000101110000100100000000001001000010000010000100000000010100011000000000110010
10000001010000000000010000011000000000001000000010000000000000000000100000100001000101000000010000100
01000000001010100100000000000000000100000000100000010001001000000011000000000000001001000000000100000
01100000000000000000000000001110000010000000000111000001100001011000000010000001000000001000000000000
00000000000100000000001010001000001000011000000010001010000000001000000010000000101000011000001000001
00000000010000010000000000000010100000000100100110000000000101000100000000000000010000000100001000000
10110010000000000000000010000010000001100101000010000000000000100000000100010000000000100100000000000
00000000000101100000000001000010100100000100000000000010000000010000001001000101100011010001010000000
00000100000000100001100000010001010000100100000001000000000000100000000000100000000000000000100000000
00011000000000100010100010000000000001000001000001001001010000010000000000000000000000000000000000000
00000000010000110001100111000100101110101001001100100001000010000001000010010000000001101111000000000
00110000100010011100000001000001100101010000000010000001000000000000000000101001000000010001101000000
01000000000000000011010000000000010001110010000000001000100000000000001010000000001000000000000000001
01000000000010001000000000000100001100000000000000011100001000000001010010000100010000100100010000100
10000000000100000100100000010000100110110010000100010000001001000000000000000000000000000100000011000
00010101000000000010000000000010101000001001101000001011000000010001000000000101000000001000011000101
00010000011001000000010000000000000000001000000100000100010010100000010000010000100000000000000000101
00010001000000001001000001011100000000000000100000100000000000000010010000000000000110010000001000000
00001000000110001000000000000000000000010100000100000001100000010100100101110100000000011100000001010
10000000000010010001100000001010001000100000000000010001011000000100000000000000100000100001000101000
