00000001001000000000000100000010110000000000001000010010010000001000000000000001000000000100000001010
00010010000000000000100000001000011100001000000000000001001011100000000000001001000000000000001000000
00000110000010000000001000000001000000000100000001000000000100010100000000000000001001000000100010010
00000000010001001010010110000000010000000000000000001000100000010011000000000100000000000000000000000
00010000000000100010000000000000000000000000000010110010100000001000000010000010110100000010100000000
00000100000000100000000000001000000000000000000110000011000010010000001001010000001100010000000010100
10000000000000001000000001010000010000000010010000010101000001000000100000000000000001000010000010010
00000000000011000000001000000000000100000000000001001000000100001000011000000000000000000000000010000
01000011000100000000000100100110000000000000000000010001100010000000000000010000000000000000001101000
00000000000001000011000000000000000000010100000010000000010000010001000000000100001010001000011001010
00000001010100101000010000000010000101001000010010000001000000010100000001001000010000000000010000000
00010100011000100010100001000000000010000001010001000001000100110100000000000000000000000100000000000
00000000000010000010100000000000000000010000010000000000000000110000010000100000001100000100000000010
01000010001000100000100001001000010000001000001010000000101000000000101000000001100100101010000010011
00010000000100100000000000000010010000000000001000000000000000100100000000000011110010000000010011000
00000000100000100000010100100001100010000010000000100000000101101000000000001000100000000000110000000
00000000010101001011001001001001001011000100000001000000000110000000001000000011000010100000000000000
00001001010000000000000001000000000000110000001100000000101000001000010000000001001000000000000000001
00000000100001000110000100010000000000010000000000001000000010001000000100101000010000000101000000001
00000000000000001000011000010000000010000100000100000100000010010000000000000000010000100010000010000
00100010000000000000000000100000000000010000000000000000000101000000000000000101000010000000000000000
00000000010000000000000000010000000010001000000000000000001000000100100000010000000000000101000000000
00000100000011001100100001000100000100000000001000100011010000001000001000100100000100010010001000001
00010000000000010010000000010000000000000001000000001001010001010010010000100010000010001000100000010
00001000000001000000000010000000100000000000100100000001000000000000101000010100110000000010010010010
00000000011000010100001000010000101000000001000010000100001100001100000100100000000000110000000000010
00000101000000000000000000000010100000001000011000011000000000000000000001010000000000000000001011000
00010100000100100100000110011000000010000101100001000000000010000101010000000010010010000000000010000
01000001010000000100001000010001010011010000001001110100101010110000001000100000000000000001010010000
00000001000000000011100000100000000000001010000000000010000010000000000000000000000000000000000111010
00000010001000000000000000000000110000000010000000000000000001010000000011000000010000000100000000000
00100000000110110001010010000000100000010000000000000000000000000000101000100000010001100000000011000
00000010000110001001010000000000001000000000001010000000000101000000000000000100000001100000000000000
10001000000000001001000001000000100000000101000000010000001000010000000010010000011000011000010000101
01000000000000000000000001000000000000000000000000010001100100100010000011100000000011000101000000000
10000000000001001010001010001010100000110000000010001000100010001100010001000000001100001000000100000
00001000010000000110000000000100101101010000000000100000000000100011011100010000100100000000000001010
11010100000010110000000000100100000000001001010000001011000001100000000000000000000100000000000110010
00000000001000000000100000100000101100000000000000000010000000000000100000010000000000100000100000011
00000001101100000000000000001010001001000000000010000000000000001011000000000000100001100000001000000
00000101000101001100000100000000001000001110010001000010000010011001001001000000000011100010010000100
00100001000000000110010000000000010000000000000000100000000000001010000110110010000000000000000000001
00100000010000000000010000001000000100000000010000010001000000000000100000010000000000001001000000000
00000010000010001000010000000110000101100000100000110000100000000000111010000000000000000010000100000
00000000000000000001000000100000000011010000001000000100100001000001000001000000000000110000010000100
11000000001100100000100010000000100001000100001101000000000100010000010000001000100000100001000000100
01001000000010000001000000000100000000001000000000000000110000000000010000010000001000000000000000100
00111000000000000000001001010000010100011000100001000000001000100000000010001000010100010000000000000
01000101101010000011000000011001100000011000000110000000000100100000100000100000100001000000000000000
00000000010010000000001000001001100001000000000100000001000010000000000110000110001010000010001011000
00100110010010110100001000001001000000100010100000000010100000000000000000110000000001000010001000000
01000010000000000001100100100000010000010111110100000000010000000000000011000000000011000000000000000
10100000000100010000100000000100010000000001000100000001100010000010000100001000000000100000000001000
00001001000000010001011100001000001000010110001110000000000010000001000000000001100101000100000000000
00100000100000001000000001000010000101000000010100010000000000001001101000000000000001000000000000100
10100000000100010001000011000000011000101010001000100010001000001100010000000011000000100000010000001
00001101000000100100000000001000000000010000000001000101000000000000011010001100000000100100010000000
00100000100000000000000000000000010000100000000100101100000001000100001000000000010000000000011000000
00001100100000001000000000000000101000001000000000000011010000000000011001000010000000000100000001010
00000000000000000001100100000000000110000000000100000100000000000100001000000100000001000010000000000
00100001001001110000010000000010001000010000000000100010000001000010000100000000000010100000000010000
00001000001000000000010000100000000000010000101100000100000000000000101100000100010001000100000000001
00010000000000000010000000010010100010101000010000101000000000001100000001000001000000000000010100100
00000000001000000000000000000011010000100000100000000000001100000010000011000000000000000000000111000
11010001000000000001011000000010000000010000100100010010000100000100001101000001010000000100010000000
00000000100010000011011000101100000000001000100100000000000000001000000010000000010000000000000000000
00010000111000010000110001000000100000000000001100000000100000000000001000001001000000000000111000000
01100000100000000000000010000100000000000000000000000110010010000001001000000110001000010100000000001
10011000010000000100000100011100000001000001000000100000110000100001000101000001010010100000000000000
10000110001000010100100001010000010011000000000000001001000000000000000001000000000001000000000000110
00000000000000000001000100001000001010101111000100001000100100000010000000100000000001000000000010010
00101100000001100000100110010000000010010100001100000000000000011000000000000000100000100100010010001
11001011001000010000000001000000000000000001000010001000000000000111010000000100010000100000110000000
00010000100100000100001000001100000000000001000000000000010000000000000011000001101000000000101001000
00000000100000101000100000010000000000000000000000000000100000000100000001000000000000010000000000000
01001000100000000000000000000000000000000000000001000011011000000110000000110000000101000000010000000
00001000000000100001000000001001100010000000000010000010100010000000000000000000100000011111000000000
00001000000100010010000010000000000000010000101000001010000000101000010100000000011000010000000000000
11000000000100100000100000000011000000000001000000100000000100000100010000000001001010000000110110001
00000001000010000001011000001010000000001000000110000000000000000001000000000101000000100000100000000
01000010100010000010000000001000000000001001000011000010000000000000000000001000000101110000100010101
00000000010011011000010110110100000001100000001000000000000000100000010000000000000010001011000000010
00010000000000010001100000000000001000010000000000000001000000110000000000000010000000001100000100000
01000000000100000100000010000001010000010001000000101000100010100000000000011000000110010010010000100
00001000000001000000000000000010011000001000000001011100000001000010010000011100000000010000001000000
10010000000110000000010001001001000110110001000100010000000010000000100000000000000001000000000000000
00100000110000000000010000000100000000010000000000010000000000001000000000000010000010001001010000000
00100000000001000000000000000000100000001000000001000110000000010000000000000000000000001000110000000
00000000000000000000000000001001101100100000101000100000000110000101010110000010000000100100001010000
01000000000000010110000001000010001000000000000010000010010100000100100010000000110100010000000100011
00011000000000000010011001000010000010000001000000000001010110100000000000000010000100000000000000001
00000000101100000000011000000000100000000000010000010100110001000000000000000000000100000000010100000
00000000000000000000100000010001100001000100000010000001000000001000000100001011001000000010000000000
00000001010010010000111001000000010000000100000000001000000011010000010101101100100000001010101000000
00001000000000010001000110010000000100010000101100000100100110011010001000001000000010000000000000000
10000000000000000000001010000010010000000010000000000000000000000001001100001000000001001100000100001
00110000000010000000010010000010001000000101000000000011010000000000100000000100111000000010000010001
00000000000010000010011010000000000000010000000001100000000000010100000000000000000001000001000000000
10001010010000000010001100000100000000000000100001000000010000000110000000100010000010100000000001000
01001000000000001000000000110010000001101001000000000010100100000000100000000011000100010000000000000
10000001000000100010100001000000000000000000011100000000100010000100000000000010000101000010010000000
