00100001001001000000000000000100000000010000000000001110001000100000001000001000000000000000000000100
00010000000100010001000001000100000000000001011001100100010000000110000000100000000000000100100000010
00000000000010000010001001000000100011000001000000100100000100000000000000100000000101010010000000000
00000010000101000000010000001100101010100000010000001100000000000001000001010111000000001000000000000
00100000010000100000000000010000001000100000000000100000000100000000001001000010000100000100000000001
00000000110000000000101010100000000100000000000000000000000010000000100001010000000110010001000100000
00000000000000001100100000000001000100001000000000000000001001110000001010000000000000000000000100000
00000000001001000000100000000100000001000110000000000000000000100000000001000001111001001000100000001
00001011000000000000000010000000000000000000000001000001011000010000000001001100001000001000010000100
00001000001000000000001010100000000000010000000010010000000000100000000000000101101000101000000100001
01100000000000000000000000000001000000001100001000001000000010000101000000000100000011000010000000010
00000010000001100000000101100100000001100000001001001000010000000000010000000100010000000000001100000
00010000100100000000100000100010000010110110000000100000010001000101000100000000001100010000000000000
01100100001000000000010001000010011100110000010000000100100010010100010000100000000000010100000010010
10000000100001000010000000000000010100000000010000000000011000000000000100000001101011000000001111000
10110000001011100011000010010011011000011001000000000000000110110000001000100010000010010010101000000
01000000000000000001010010000010000010000000000000000100100000100000011100010000001001000000000000001
00000100011000000100000010000001100000010000000000010100100100000000000000010000000001010001110100000
00010110100000001000000010000100000000010110010001010000001000000000000000000000100101000000000000000
10010001100000000000010001000100000001000000000101000001000010000000000000100110101000000000000010010
00000000110001000000001110000100010100000000000000011000000100000100100001000000000000000000000001000
00100110000000000000010000010001000000001000000000000001100001010100010001000000000010001000000000001
01000000000000000010100100000010000000000000000001010010000000000010110000010000000000010000000000001
01011000000100100000101000010110000000000000000000001100000010000010011000000000000000001000000110000
01100100101011001110000011000000010100000000000011100000000000011000000011000000011001011000000000000
10100000011000100010000001010101000000001001010000010110000000000001010110000011001001100000000000110
00100000000010001000001000000100100001000001010011100000001010000011000000000100000000000000010000001
00000010010000000001000000010000001000100000000000000110000000000000000110010000000010000001000000000
00000000101010010001000000101100100010010010000000001000001100000111000000100000000010100110000101000
00101000001000000000000000000001010001001010001001010000001000101010100001000010000000000100000000100
00110110100000101000001000000000000000000000000000000010000011000000000100000001010001001000000100000
00101001100011000000000000000010010010000110000000000000011010001000000100010010101000001000000110000
01000001000001001001001100000000100010110110100000010000000000000000101000001000000000000001000001000
00000001000011000000000001010000000010010000101000001000000000010000000000000100000100000101000100000
11001000100100011110010110100100000000000100010000000000000000110000000000001001011000010000000000000
00000010000000010010000000000000000011001000000000000000000001010000000110010000010000000000000000000
00000000100000000000000000000010000000100000000010000000000101100000001000001000000000000001100001000
00000000100100001000001000000110001000100000000001010010000100000000000000001000010110000010100000000
00000001110000000111000001001000000000000000000100100010101000010000111010000000011000001000100000000
00011010000010100000000100100100001000000000000000000010010000001010000011000000100010010001000100011
00000000000101100101000000001001000000101010000000000010000000000000100100000111010001000010001000000
00000100100000000000000000000000010000001001010000100001000010000000000010000000100001000000010000100
00010100010000100000000000101000010100000000000000000101000001011100100001000011000011000001000101010
00010100000000000000001000011001000000000000000000100000000000000001000000000000100000000001011000011
00000010001100000000010011010100000001000000000010000010000000010000001000100000001010000000000000000
00001000010000000010100001000100101000000000101000000000010001000001100000011001100111010100000010010
00010000000000000010000000000000000010000000010101000000100000000000001000000000100001010000000000100
10010000001100000010000101010000000011010000000000000101100001010000001000001001000001001000000000001
00010000000000000000100000000100000011000000001100100000000000100000000100010000011001010001000000100
01000010000000000010000000100000100100000101000000001000000000000010000001101000110101000000100000010
01001010000101000000000000000000000010000000100100000000101100000000000100011010010000100000000000100
01000000101001010000000000000000000001100010000000001001000000110000001000000000100000000000000011001
00001010010000000001100000000010000000011010010100000000010000000000000000000010000000010001110000010
00100011100000000000010000011000000000100100000111001000000001001000001100000011000000100100101000000
10110000000000010000010001000110100010000000000011101001001000101000010000000000000000000000000000111
00000000000000000000000100000001000000000000000010000100000001001001000000010000000000000000000000010
00000010100100101100010000000000000001010000000000010000100000100000000000101100000010101000000001100
00000010000000010001100100000000000100001000010000110000001000000101101100000000000000000000000000001
00001110000000010000010000000000000000000000000000000100110001101110000000110001000001100010000010000
10000001110000000000000000000000000000001000011000101100100100001100000000000000100000000100000000001
10000000000000100001000000001010100001000000000000100000100000000001000001000010100000001010000010001
10000000100100000100010000100100010100000000100000000000000000000110000000010000000001000000000000000
01001000000000000000110101100110000001000000001001010000010010000000001000000010000001000111000000000
00000001100000000000100000000100001000000001000101000000000010000000000100001000010001010010000000000
00100000101010000011000001000100000101001001000101001000000000001000000000100001000001000000100010000
00000010100000100010000000101100010001001000010010000000011010000010000000000000100000001000000000000
11001010110001001000000000010100000110000010000000110000000100010000010000000100000100000000000000000
00000001100000010000010000001000000100000010000000001000100000000000000010000100001000111001010100100
00000000100010000000000001100000000101001010000001011110000000100001000010000000000001000010000100000
10010000000000010000001000000110000001000001100001000100010000000001100010100000001100000001001000011
11010010000000000000000001000000001000001000000000000010100000000100010000100000010000000011001000000
00000110000000000000010110000000010000001000111000010000010000000000000001000000010000100001000000000
10001011000000010001100001000000110000000000010001101000000000000100000101000000100000000000100001001
00001000000010000000010000000000100001100110000000100000001001010010000101100000000100001000000000000
01001000001000000000000010010101000100000001000001000000000000000000100100000100000000000100100001000
00000010000010011000000010000000000000001000000000010000001000001010110000010000010000000011010000000
00010000001100000000100010000101000000100010010000000100011100000010100000000001001000000010010000000
10000110100000101000000000000100111100000000100000000000010010001010000000000010000001001001000000000
00001010001000000001011001000101010000000001100000000001000010000100000001010101000000010000000010010
01000001100001000000000001000000000000000000000100010000000000010000000010000010000010000010000001000
00100010100000010000000000010000010010000100000000000000100001000001000000000000000001000100000100001
01001010000000001100000000100010010000000000000000100000000000000001001000000100000000000100000000001
01100000000110000110100000000000010000010000101001000110001010101010000001000000010001000000010010000
10000000000000010011100011000000000000001000001000000000000100010011001000000000100000000010001000000
00000000000001000000000100000000101000010000010000000000000000000010000000000000000101001100010000000
00001000000110000001001000000000000000110000000000000100000010001000000000100000001000000000000010000
00100000100000000000100001010001000110000000100001001000001001000000000010000100100101001010000001011
10110000100000000100000100000010000000000010010100000001100110001000100000000000000100000000010001001
00100000000000000000000110001010000000010000011000000000000000000001000000010000001000000000000000100
00000110000000000100010000000010000000100000001100100000000000010000101000000000000000110000000000010
00000000000000000000110000000010100001001000001000000101010000000000000001000011001001000100001100000
10110000000100101000000110100000000000000010100000000101010100010000000000000011000000010000010000010
01000010000100000000001000100010100001100101000011000100100000000000000010000000000010001000100010010
10000000000000000000000000010000000011000000010000010100001011000000000000000000000000101000010000010
10000001001000010010000000000101000000010100000011000001000000110100000001000000010000001100100000000
00000111000001101000000100000000010000000000000000001100000000000000000001010000100001000000000100000
00000010000100000110011100000010000000000000000000000000000000000100000100010000010000000000000000101
10001000001000000000001000000000000001100000000010000000000001010000011001000000000000000000000000000
00011000000000000000000100000000001000000000000101000000000100001010100001100000000011100100001100101
10010000000000010010011000110000010000100000001111000000000001010100101000100100000101000000000000011
00000001000000000100001100000000000001000000000000000000000000110001000110000100000000001000000101000
