01000010100000010000000000001100010000000000000000100000000000100000100000011000000000011010100000000
00011000000000000000010000001000000000000000101010001110000000000000010010000100000001001000000000000
01011000000000100000100000100001001110000100000001001011000100000100011101001000000000001000000000000
01010100011000000000000011001000000000000000000000010100000001100001000010000001100001000000000000100
00000010010000100010010000000100000000000000000000010000010000000100000000000000001000000000000000000
00000000000100101000100000000000000001000100000000001101000000000100100000100000000000000000010000000
11000010000000000001101000000100010100000010110000100101010000000001010000000001000100010010110010001
00000100000001000100010000000100101010000110010011011000000000000100000100010001000100000000011000000
00011000010010000000000000000010100100000100001001010000000000100001000001000001000001000111001101000
00000000000000000000101001000000111100101000000000000000100000110000000001000000001100010000000000001
00000111000001000000000001000010010000011010000110000000001000000000000000010000010000000010000110000
01010100010001000100100000000000000000000000000000000000000001010000000000100100000000010000010000001
00000000000000011000100000000010000110000000000000000000000001010000010000101101000100000000010000100
00000111100000100000000000000000000010000000000000001000010000000000010000111001000111101001100010101
00001000000001001000100011000001011000001000100010001010000000000000000000001000000011100000000100000
11011000001000110000010000000000000010000000000001001100101000000000000001000000100000000100000000001
00001110000010100000101010000000000000000011000000011000000011000010000010010000100000100100000000010
01000000000000000000000000000000001000100000000000010100000010000000100100100010000001010010000010001
00000011000000010100001001000000010010000000000010010100100000000001000001101000001000010000001000001
00000000001100010001100000100011000000100000001100001000101010010100001000000000000000000010000000110
00100100000100110001000001100000100001001000110100100001100001000111001000000000000011000000101000010
00000110000000000110000000000000000001010000000100001000000100011000100000000000110010000000000100011
00000000010000010000000101011001000000000000010100000000000000000000001000000000000000010000100001100
00000000010000100100000000011000100010010010000000000000001000000001000000101100001000000000000000000
01000000000000100000000000000010010011000100000010011000000000100000000100000001000000000010010000100
01000000000000000010110000000000010001000000010000001000000100000000000000001000000000100000000000000
01001000100000001001010010110000001011010010010000000000001101101100000010100000001000001000001001000
00001000010000110001100001100000010001000000000000000000000001000100110100000100000001000000000000000
00001000000100010000001000001100000010000000000000000000001000000000001000100000100100000010000000000
00000001000000100000001000100000010000100000000010000010000000000000000000110000000100000000001100000
00000100001000100100000000001000000000100010000001000000000000000001000000000000000000000000000100010
00010001111000000001000000100000000000001000100000000000100000010101000100001000000001010000000010000
11101100100010100000000010001000000000101000000100001001001000000010000000000011000000000000000101000
00100010000000000000010010011000010100010000010000000000000000000000100000010000000100000011011100000
00000000100001001000000000000000110001101000100011000000000110000100001100000100000000000001000101000
10010010001000001000001100010000000000110000000000000000001100001000010000001001010000000000001000110
00100100010000110001100000000100000001000000000101000000000001100100000000100101000100000000100000000
10001000000000100010000000000000000011100010010010010000000000000011001000101000001000000000011000000
00000001100000000000000000110000010011100100000000000000111000001100000000000100010001010000001010100
10000100001000010000001000000000000000000010010110001000001000000000000100000101000001000000010000000
10100000100111000000010011000000100010010010000001000000000001100001001000010100001100100000000000010
00110000000010000101000011010010101000000000001000100000011100100000000000000010010001000000100010010
00000100000010000010000000000010000100010000100000001110110100000001010010000000000010000000001001110
00001001011001000010010000000000000010000101000010000000000100000100000000000000010001000000100000000
00010000000000001000010111110000010000000000000010000001000100000101100000100010010001000001000000000
00000000000001100000111001000001000000000000000010100000000000001000100000000000000001001011010010000
10011001010100000000000000000000100001001000000000000100100011000001010100000010000010001000000000100
10000001000000000000010100001000110000000000000000000100000011000001101100000000001000001000000100001
10000000000000001001000000001100010000100010000110101000100010000000000010100000001010001000000100011
00000000000000000000000000000000000000000011000110000001001000011000000000100001001001010000001000000
00000000000001110010001100010000000000010101000000010010000000001101000110001000100010000000000010001
00000010000000000000000001000000010110000110000001001000000001000000000010001100001000100000100000100
01110000001000000000101001001000000100001000000001111000000001000000001000000000000000110110001110100
01110001000000000010000001010010000000000010000000000110001001000000001001101010000101000001100000001
01000000000010010000000001011000000000010000000000001100100000010000100000000010010000000000000000000
00000001000100010101000100000000000000000010000000010000100001000111000000010000000000000000010000000
00000010010010010000010101010000000000000100001000000010000000001000001000000010100000000001000000100
10100101111001000000000000100000001100000000001010000000000000000100000010010110000000100000000000001
00000110000010000000000001000000000000000011000100000000100101000000001110001101010000001001100011000
00100101001110000001000010000000010000000000001100000001011000000000100011011100000000001000000000001
00000000001001010000010010000000000000000011000001010000101000000000000000100000010001001000010000000
00010000000000000000000010000000000110000101010010000000001001001000001001001000010000011001000000000
00100000001000000110010001000000000000110001000000000001000001000000000010010000011100100010101000000
10000011000100001101000000010010000000000011000110000001100000000000000000000000000100010000001010100
00100001001010001011000000010010010000000000100010010000010101011010001100000110100000000010001000000
00000000000000000010010011101000000000000010011101000100000001000000001010100000001000000000000000000
00000000000001000000000000000000000000000100000010011000000000000000001010000000101000000000000100000
00100110010000000010000000000000101000000000000110000100000010001001000000000011000100000010001000001
00100000010000100000100000110100101011100000100000110001000001000000011000000000000100000100001000000
00010010000000100010011000000001000100010000000110000001000000001000000010000000100100010010000101000
00010000000000010000010000000100001110000001000000000000000101001000010000000000010011000110001000000
00000010000001100000110101000000000001100000000000000000010000010000001001000010000000010011010110000
00000010000000010000000110000000000000100000000000000011000001000000000000000100000000000000010000010
00010001000100000000010000000100000010010000000000001000000000000001000010010010010001000000000000000
00001001100101010001100001001000101100000000000000110000101000011000000000000000000000001010101100000
00010000001000000000000000001110001000000100000010010010001001010100100100001010001010000110000100000
10000000000001001000000000001000000000000100010000100000000010001010000000000110000000000000000000000
00100000100000000100000000100010101000000100110000010100000000000000000010001010000010010001000001000
00110010000110011000000000100100000000000000001000000000100001110000000001001001010010001000000000010
00000000000000000000000001010100000000000001001101001000001000000001001000001000001000000000000000000
00000110001101000100000001100010010001010001000010000011010101010000001000100010000000000010000000000
01010000000101000000001000000001100100000000011000000011000000010001100010100000000000000000000000001
00000100001010000100000000000000000000001000100001000001000000000000000000000000000000100101100000110
00000000100000000001000000000000001010000010001000010000101010010000010000000110000100000000000000001
00000100101000000000000100010000001010010100000000000000000100000110010000010001101010010000000111101
10000000000001000000000000000010001000100000000100110000010011000100001000000000000010000000101000001
10100000000000000000000000000001000000100000000000110010000000000000001010000000000000110000010110100
00000000010000000000000010000011101001001010000010000001011010000000100000010000000000000100010000000
00100000001000000001001100000010101001001100000000010000000000010000000001000000000000100000000000010
00000100100100101000000000100100100100010110001000000000000001000000110000000001000000000001010010000
10010000000001000101000000000000000010100010000010110010001000000101010100110001000000010110100011000
00000010100000000000000000000001001000001010001000001000001001000111000010000001100000010000000000100
11000110000000010000000100011001100000000101000001000000000100010000100100000001101000001101000000000
01000000100000000000000000000010100001010010100001001010000100010000000000100001000000000101001000000
10000100000100000010000101000001000000000000000100000100101000000000010001000001101010100100001001000
00000000000000010100100110010010100000000000000000011100010000000000110001010100010100001000000000100
01000010000000000100000100000000100000001000001001100000100001000001001010100000100100000000000000000
00000000000000110100001000100101000000000000000000011000010100000000000000000010000110000000000001000
00001000001000000000001000000000000000000000001000100110001000000010000000000001010100000000000000000
00001000001000011000100100110011000000010000000101010000000100000000000000000101000000010000100001001
10000001000000000000000000000100000010000000000010000010010100010000000000000000000001000000010001000
