00010000001001100000010011010010001000110100000001000100110000000100010001000000000000010000000000000
01000100000000010100000000011000000000000000001000010000000000000000001001000000110010000000001001111
01000000000000001000101000110000000000000000100001000000011000000001000000000010110101000000000001000
01000011010000110000000010000110000000000000000000010001010000100110000100000010000100100000110110000
00000001000000010100000000000010000000000000000010000001110100000000000000000000001000000010000000000
01000000000000100010010000000000000000000000110000001000001001110010000000000000100011000000110001000
00010001000010000000000010100000000000001010000010000000000100000000000100010001000010000000010010010
10000011010000001000010000001000010001000000000000000000000000010000100000001000100110010000000000100
01110001000000110000010110000000000000110000010001000000100000010010010000000000100100000001100010000
00001000000100000000101000000100010000000110000000010010100000000100001000000010011011000000000001000
00000001000010000000000001101100000100000000000000100100110000100000010000000000000000011000100001000
10010001101001000001000001000000000000000000100011100000000000000000000000000000110000000000000000000
00001010010000010000100000000000000011000000000000000000000010010000000000000000011000001100000000000
01101000001100000000000010000000001000000000010000000011100000000010101100000000000000000100101000010
00000000000001000000001000000101010010100011000000000000000100100000000000001100010111000001000010000
01000010000000000010010100100000000000110010000000001000111000100101011001001000000000000001000000000
00000000001000000000010000010000000010110000000000011000001001100100000000000000001001000001100101000
01110000000010100000001000100010101000000010010000001000000111101001010000100000000100101000000000101
00001000101000010000001100000001001000000001010000000000000000100010000000000010000001000000111000101
00001101000100100000000010000010000000000100000000000100101000010000000000010001010000000000100000100
00101000010000001010000100000000010010000011000001000000010100000000000010010000010010011100000010000
11000000001000000100000000010000000000000001100011101100100000100000101101000000101000000000000000100
00000000000000010001000100000100010110000000000000000000000000000011100000100100100010000000010000101
10000110101000100100000001001100000001000110000000001000100100000001100000000000000000000000000001000
00100000010000000010000000001001000001000000010000000000000100110010001000000000010000000101010000000
00000000100000000010000010000100000010000011000100000000000000011010000000100000110100000010000000000
01001000010010000010010010000000000000000010110101100010010000100100101000000000000000000000011000001
10000100100001000010100111000000000000001010001000010000010000010000100000000100000100100000010010000
01100010001110001100011101001100111000110100000000000000000001100000011000000101000011000000010010000
00000000001000000000110000000010000000000110000000000011000000000100000000000000100000110000000000000
00000100000001100000001000001000111000010011000000000000010001000001010010111010010100000011000100000
10110000000100101000000000001011000010000001000000000000100010000011000100000000001000110000000000000
00000100000000000000000000100000100010000000100000000000000100000001000100000000000010010000000100000
00010000000100000010000010011001000100000000000000000000010000000101010000001000000100110000000000010
00000100000000100011000000000000001110000001001100001001000000001001010000010000100000000000000000100
11000000100000000000000001000000100110010100000000000000100000110000001000000000100000011000000000000
00000001000000001000100000000000110010000000001010100000000000011101010000101110101001100001000100001
10001000000000010000000000000000000000101000000000000000001000010000000000110000000000000000001001000
10000000010001000000100000001100001001110010000010001010100000000010000000000000110000000000100000001
00100000000000010100000100000000000100100000001010000001000000000000000111000100000000010000000001001
01100110000000100000000000000001000110000100100001011000000000010000100100000100000000000010011000101
00000000000000110000000001000001010000000000000000010100000001001000100000000010001100100000000100100
10000000000001010000001001001000000000010000000000100000100010000001000100010001000010000001000000010
01100000000000000001000000000010100100010010100010100001000100000100110000000100001000001000000000010
00000000000000010000000000010000000000001000000000100010000110000010000001000000010000000100010000000
00011000000001010000000001000000100000000001100000000000000110001000100110001100000000100001000000001
00011001001011000000010001000010000000000000000000000000000000100001000001001001000000000000101000000
00001010010100000100000001010000100000000000010000000000000000000100000110000000000100010100001100100
11000000000000010000000100000000011110100000000000010000010001010000100000010000000100000100000100001
00000010000010000101001010000000100011110000000000010000110000010000100001100000000000000000011000001
01101000000010010000101001001100000000000101000000101000000110001100100001010000011000000001100000000
01011110000000010110101000001001100000010000000000000001000000011010000000000000100000000000010010000
00011000000000010100000000000000000000000100100000100010011000000010000010101010001000010000100001010
01001000000000000000001010000001001001000100110000000001001000100011000000000000000100000101000000000
01000000000000000000010100010000000000000000100000000010000000000000000011010100010000100010100000000
00100000000000000000000000000000000010000100000111100000000011100100000000010000000000000000000000000
01000000000001010000000000100000001110000000111000000001000001000000000000000000010000000000000000000
00100000100100110001000000000000000000000100010000011000011000101000100000000000000001000100000000011
10100001001000010101010000000000000101100000000000000000001000000000000100000001000000010000100000010
00000000000000000000000000000001000100000001000101011000101000000000100010000010010110000010000001000
00000000000100000000001000100001100010010001000010000000011110000110000000011000000000010001010001101
01100000110000010000000010001000100000000010000000101000010000010000000001000011000000000000000000100
00010001111000000000000000000000110011001000000001000000000000000000100000001000000001001011010100010
00000001000100000100100101000000110000100000000000100000010100000001001100000001000000100000001000100
01010001000000101000010000100000101001001000011000000000001101000000000000000101110000001000000000000
00000000000000000001001010000100001000000000110000000010011001000000000001100100000100000010000000000
00000001000000100011100000000000100011010000000000000000000000000101110000000010000000000000010010000
10000001000000100000000011000000000000001010110100001100100000101010010001001000001000000001000000001
01100100000010000100010000000100000000000010010010000001000101010010000010011010000000000000011100000
00000010000000000011001000001001000010100000000001000000100010000100000000000000000000001001000000000
00000110001000000010000100000011000000000000100000000000001000000110000000001000000000100000000000110
10010000100000000010000010110100110100000000100000010010001000000100100010100100000000000000000000100
01001000000001000001000000001000000100000000101100000000100010010000000010010010000000001000110001100
00000000000000000000001000000001010010001100000100000101000000000010001000100000000011001100000000011
00010000101100000000000000101100100000000000000011000100101000000000110000001000001001000000101100100
00110001000100010010011010101001100100000010001000100000000010000100000000000000000001111000000000000
00000000001000001000010000110000000000100001000010100100100011100100010010000000000000100110000000000
10000000010001010000000000000001100100101000011000000000100000011010000001001010000101000000010000001
00000100001000001000000000000000010000100000010100000001000000100010000000000000000000000100000000100
00000011000101110000110000100000000000000100010010000001010000000000010000000000011010011100000000000
10000100001001010000000100000000001001010001000010001000001000001000000000110000001000000000000000000
00000000100010010000100100100100000100000000010000000010000000010001000000000010000000111010000000000
00001000000100110000001001010010101010000000000000000000100101100000100001100000101011000000000000000
00000100001010100001000000100000001101000000000000111000000010101100010000000000000110100001000101100
01100000001000010010000010000001000001000100100000100000000001000100100011000010110000000000100000010
00100101000001101101100000000000000000000010000000001100010000100000000000000000001000010101000000100
01000000010000000000000000011000000000001110000010100000100100000101000000011000000000000000010000000
01101001000000001001000001010000000000000100000101000001011000000010011000100000100001010000010000000
00000000010100010000000000010000100000100000000110001000000000000000000000000100110001100010000000010
00100010001000000000000000001001010000000000100100001000000101111000000000100000100000000000000010000
00000010000100000100010000000100101010000000100000000000000001001001011000010001100100000100000101100
00000001100111010000001000000000000001000000010000000000010000100000010000000100000101000000000000000
00010001000000000000001001101000000100000000000000000100001000000000100000001000011000000000000011000
01001100000000101000000000000000000010100001000110100010000101000000010101000001000000001000100010100
00000001001000001010000000011000000000000010010000000100001010000001000000010000101000100000001011001
00000000010010000000000100011010110110110000001000010000010010000000000000010100000000000001000000010
00000000000000000110000000000011000010000000000100100100000010000000000000000010000000010000110100011
00111011000000000000000000000000010010000000000000000010010001100000000010000010000000001010010110011
10001100000000011000001001001000010000100010000000001100001010010010001000010001100010010110001011000
01100000110000000000000010000000000000010001010011000000010100000100100000000000000100011000000000000
01100000100000001101100100010000000110000000000001000000101000001001000000000000010000000001000001000
