00001100001000000010000100010000000100010000001100000000010001001000001000000000000010000000001010000
10000010000001000000010100000000000000010000100000000000000100000000000000000010001000010000000010000
00000000000100000101000000010000000000000000110000000000100000000000010100001000001011001000010010000
10000100000000000100001000010010000100010010110010010110001000000011001000000001000000000000000000000
00000001000100100000000000010100101010001100000000010000000000010001000000000010100000001000000001000
01000100000000000000000000010000101000000001000100000100010010000000101001000000001000000011010100100
01010010110010011100000100010000000000000010000100100000000000010001000010000110010000000111111000000
01100001000001000010010000000000101000000000000100000000010011000110000000001000000010000000100000010
10000000001000010000010011000001000000001000000000000000000010010100001001001100000000100001010000010
00010110001000001000100001010000011000000000100100000000100000000000100000100000010000100000000101000
10000100000000000000000000100100010000000000000000000000000000001010000000110000000000100000100000000
01000000000000010000100000100000001001000000000001101010000000001010000000100000000000000111010100100
00010000000000101000010010100000000000000001000000001001000000000001010000100000100000001001000100000
00000010000001000000000000110100110000010001010000101000000010001001000000000000001000110000000011100
00000000100000000000000000001010000000001001000000101000000000100010010000010010000000000000001010001
00001101101110100000000000010000000000001000011000110000010000110100100100000000001110010000010101010
10011011000100000000000001000100110100010000000010000000000101000000000000000000000100010010000000001
00000000000000000010000000000000000100100100100010101100000100001110000100000100000000000000000000000
00000000100110010000000000000000000010110000000000001000000001000000001000000011010100000000001001010
10010000001011010000010100000000000100010001000000000100000000101000000000010000000000000010001000000
00000000000000000000000100000100001000001010000000000001011000100010000000000000000000000000110000000
00001000000000000001000001000000000000001000001010011001000100000010000000000000000110000110100000000
00111111000000010000000000110001010100011000010000000011000110000000010000000000100010001000000010001
01000000000000100000000100100000001110000000000000001100000100000000100000001000001000000000001011011
00010000101010000000000100000101000000011000001100000001000001000000010100000110000001000010000000010
00100000100001000000000000000010010010000010000010001000010000010000000010000000010010000001000000000
00000000000100000010000110010011000000000000000100000010000100000000000100000000101000000000001000000
01100010000000000010100000001001000010010000000000100000000000010110100011100000010000010000000100001
10100000000000100011000100000000000010001010000000100101100001101000000011100100000000100010000000010
11001000100000000010100001100001000100100001000000100000000010101010010000101000010010110001000000001
00000001000000101001011100000000000000000000000000000000000100000000000000101100000001000101000100000
00100000111100000000010000000000000100100001000000100000000000000010100010000010100100100001100001100
01000001000000000000100010101101000100000000100000000000001000010001000000000000000000110000010010000
00010000111000000000000000000010000000001011000000000100000010000000000001001010000000000000001000100
00000000101000000010000000000010110000000100000010010100110001100000001010010001111001000000010000000
01110000000010000010000000000100001000000000001000000000000000000010000010001010001100000000010000000
00001100000000010010000000110101100000000000000000000100000000010100000100010001001010000000000000011
01000000001000101000100100000001100110000000101010001101000110011100000000001000001100000000000000000
01000000000000001000000000010000000000000000000100000000000010000001000000000010010001000011000000010
01000001000000000111001000000001000000001000000100000000000000101010101110101000010010000000001010000
00100000010010000001000111000000000010010001000000110000000000000000000000000001000111000000100000000
10101000000000000000001110000000000001100010110100010000100000010000100001000000000000000000000000010
00001011110000001000100100000010000100000001011011101000010000001000100100001000010000000001010000010
01000000000100000000010000000000001000110000000000000000000000000000000010001100010000010000000000000
00000101000100000000000000000011000000000001000100000001110011010010000000011000100000001000000100000
00100000010000000000000000000001000011001010001000100001010011110000010000000000000000100100001000000
10010100001100100010011000000010000100000001010000010000010011000100001000001100000010000000000010000
00000000001000110010100000000110001000010000101000000000000001000000000100000100011001000010010101000
00000010000010000010000001000110000000100001100010001101100010000000101011000000000110101000000001010
10000100000000010000110001000010000010100000100011001101000000000000000100000000000100110000001100000
00000000110000001010001000000000011000000000000000000010110010000010000011001100010001001110010000000
00010000000000000010000000000000000000000000110010010000000000001010000001000010000000101000011001000
00010100001001000000000001000000000011100010010010000000001001000010000000101000000010110000100000100
10000100100001000000000110101100010100000010000000000001110000001010000000010000000000000011000000010
00010000010101000000000100000001011010000000000100000000000000001000011100100000101000000010000001100
10110000001000100010001100010011000000011000000000000000000100000000100000000000000000000011000000000
00000000001001000001000000010000000000111000100000000000000100101010010001000100000100100001010100000
00000100000000000000100010000000100010001000010000010000000000010101000100000000100110000000000000010
00000011000100001000000010000110010010010001100000000000010000000010100000010000111010000100000000000
00100100000000000000100000000100001100011001010000001000000001000100001100000010001000000000100010000
01010000000000100000000010000000000110000000000000001100001000100000000000000100100000001001000010000
00000000010000000101000000000001100011100000000000010000000000000000000001000011000010000100010010110
00000000000100010000000110010000000010100000000110000010000000100000000000101010100010000111000000100
00000010010000100100000000000001000001000000011100111010000000100000100000001000101000001010001011000
10000011000000000100000001000001001101000001000100000000010100000000100010000000001010100000000100000
00000100101100000000000000000000001000101100000011100000001000000100010000000000000000000000000010000
01000100000001000010000100000010010000000010011001000100000000100000100000001000100000000000000110001
00100001000000000000100000000001000001010010000001000001000001100000010001000000100000000011000000001
01010000000000000001000000000100000011000100000000101000000000000100100000000000000000000000000110010
00000110000000000000100100000000000000000010000011000000000100000000001110100011000000000000011001000
00000010000000000010000011000000000000001000010000100000001010011000000000000000001000010000001000101
00000000000110000000001101000001000000000100101000000001010000000000001100000100010010000000010000000
00100000101000100110110010000000000000000000000000100000010100001000100000000010000000110000000000000
00000000010001000001100000010001100001110000010010000010010100000000000001101000000100000000001000000
00000100100010010010000000000101000000000010000000100100000000010000000011000000101000010000000010100
01000000001000000000000110100000100000000000100100001010010000100000010000111010000001000100100100000
01101000000000010000011000110000000000000000001100100000000000001000000000000100000000101000111000001
00000000000101000000000001010000000000000010000010001000001010000010000000000000001000000000000101001
00000010010001000100100010000000000000000000000000000000000000000010000010000010000101000010000000100
00000000000010101000000010000010001000001010010000111100010000000000000100000000100100000000011111010
10101000001000000000100000010000000000010010000000000110000000001000001100000000010000000000000000000
00000000100000000100000000110010000000010000100000000000010100000000010000000111001001000110010000000
00000001000100010001000000000000001000000000000001001100010000000100000010011010000110100010000010000
00110000110010000100000100000000001100100000000100001100100100000000000001000010100000000001000000000
00000000000000000101000001100000000000000000000000000000000000110100001011000000010000100000000000000
11010000100000000100001000001100111000000001000100000000000000001001000000110101000000100100010000000
00010010100000001000011000001010100100001001000001000000000010000000000000001000000101100000000010010
00000110000001001000111010000000110000000100000100000000010001000000001000000000010000000101000000011
00000100000001100001000001010000000000010001000000110001000000000000001000010000000000000000000000001
00000000100000111000000000000000000110000000011000001001010000000000000001001001000100001000000101111
10100000000000100000110000000010010000110000000000100000000001100100100000100010010000100100010010010
00000100100000000100100000000000000000000100000000101101101010000000000000101000000000010000000101000
11110100100110000000011000000000000000000000011001001000110001001000000100001000010001100010010010001
10101000001000001000100111110101001000100000000001001000000000001011000000011000000100100100000000100
11000001110000001000000000000101100000000000000100100000000100001110100010001010000000001001000000000
00000100100100000000000000001001110000000000000000001000000111000000001000010100100000001110000000000
00000000000000001000000000010000010001011000000000000100000000000000100010010000100010001000100110000
10000100001000100000100000100000001010010001000000010000000001110100000100000000000010111001010010011
10000010000000001000000001000000010100000000000000010000000100101000110001010001010000000001001010010
01001000000000100000000000001000000010001010000000010000010010000000001100101000100010000000010000000
00000000010000000100000000000010000100000011010000000001000100010000010000010000000001010000001000000
