00000110010000000001100110100000000101100000000000110100000000000010000100000000000000000000001000000
01000000000000000100000000001000000100101000011000000000001010011000000110000000000011000000000000000
00000000001000100000010001011100000000010000100000000000000000000100000000100100000001011100010010000
01000001011000010100000000010000000000000000000000000000000100000000000010011000000010010000000000100
00000000001001000000000000000010000000010100000001000101000001000000000000000001000000101000000000101
00100000110000000000000000001000101101010100100000110101000000101101010000010000000110000001011000100
00001101000000100000000000100010000101010110000000100001000010010001001010001001000000000000010101010
10000000111000001001100010000010000000010000011000101000010000100100000000001000110000100000000000000
11100001000100000000000100010010100000000100100000100010100000000100000000000000000000110100000010000
10000000110000000000000010000101000000111000001000000010010100001001001010010100000100000010000000000
00000100001000000001000000010000000110100010000010010000001100000000011000010110110000000000100000000
00000000010000101000000101000100000010000010000000000011000000000011010010000000100010110100000100000
00010001001000010001100100100000010000010110001100000000000000101000000000001001000101000111100000000
00100100000000101000000000000000000000001000010000001000010000000000000000000000000000000010100000001
01110011100000001001000000000000100001000100000000100000010100000100000110000001000000000000010100011
00000100000000000000100000000000000000100000010100000100000000000000000010000000000001000000011010000
00000010110000100000000001000010001000000010000001110000000010000001010101110001000010100010000000000
00100000010000110100001100000001000100100000000010001000000000000000001100000010000000010001101000000
01010000010000000001001010000000000001000010001000000000000000010010000110001000000000000010000001001
11000100000001100000000001000100000110000000001010000010001000000000100101010010000000101010111100000
00000100001010110100001010000000100000000010100000000100000000000100100000000000001100000000000000000
00111000000000010001101010100000100000000010000001000110100000000000000010100000101000000000000000000
01000000000001000000100000000000101010000000100000000001000010100000110000010000001000101000100000000
10000001000001000001000000000000010000011000000000100000100000000000010000000100001100000010000001010
11000000000000000000011100100000010000000000010000000100100011100000000000100001011000000010010110011
00000000100000000000000000010000001001010010100000000001100000001000001001110000001100000100000000000
00001000010100000000001000000000000100000000100000100000000000000000100010000001000000000000100000000
10000001000001000000110100000010011011001001000000000000000010000011000000000010010100101000011000100
00000011010010100000000000001000011000000000000000000101010000000100000000000011000000100000000000000
00010000010000000000100010000100000000100100000000000100000001100010000001000000000000001000100100000
00010000000000000010000010000000100001000101100100110000000001000000000000001000111000010101000011001
00000011101100000010000110001000000000000100000000000010100000000110011000000000000010000000000000101
00010010010001000000000000000001000010001000000000000000000010100000000001010111000000000001000000000
00100010100000101001000100100000000001000000011000000001000000000000000100000010010000000001100000010
00010100010110000100000000000000000010000000100010000101010010000000000100000100100000000000000001100
00010100000001110000011000000001000000000000010001001000010000001000000110000010010110010100000010010
01010000000111000010010000000000001001000011000001101000001000000000100000000000000000000000000000000
00000000000000000010100001000000011001000000010111010100000000000000011100001000100000000000000010000
00000000000010000000001001100000000000000001110001010000001000011100010000001000000000000001000000001
10000010000000000000110100100000000110001000100000000010000010000000000001100010000000000000000000000
11000101010001000000101000100100100000000000010010000000000000010100110001100000000010010010000001001
00000001000000000000000000010000000000001000100000001010000000010000100100011100000001000000001000011
10000010010100010010000001000100001000000000000100000100000001000000000000000000010100001000000001000
00001101010000000000000000111010000000001100100010100010100001000010000001000000100000000101100000000
01000101000000000000000000110000000001010000000001101000100000000000000000000010000100110000000000000
00110001000010000000110000000010000000100010010010100000000000011010000000010100000100101000000000000
11000001000010000000010100000000000001001100010100000000000000100010100000000000000000100000000010011
00100010100000000000000000000001000000001000000000100001000000010001010001010000000000001000000011010
00011010000000110000010000110000000001000000000000010000000000000111000010100110100101000100000000000
00000000010100001000100000010000000110001100001000001000010001100100000000100100000000000000100000000
01010000000000010000110000100000000010110000000000000001111000000010010000010100000000000010000100000
00100000100111000110100010000001000110100100000010010000000010000101000000000100000010000001000000001
00000000100101010010000011010000000000000110000000000001000011000000000000000100010100100000000010000
01000000000110000000000000000001010000000000101000001001000000000110010001110010000000000000000000000
00010000000010000001000000010010001011100000000000000000100011101000000000000010001011001000000000001
00111010001000001000001010000100000001100010000010000110000010000000000100101010000001000000101001100
00000000000000000000000000010000000001001000000000101000000000000000000110010000010101111100100000001
00000001110110001000011000000000000000000000010000010111000000100100000000000000001000011000000001100
00000000000010000000101100111001000000000000000100001010100001000000100100000000000000000100000001000
10000000100110100000000000000000001001000010110000000000000000000000110000100100010000000000000000001
00100000100000000000000000000100000001000000000000000110101010000001010100010001100010011000000110000
10000100001000000010010010000000000001000010000010000000000001000001000001000010000000000000011000000
00000001000000000001001000000000000010000000101000001000000000001011000010000101001000000011001000010
00000000101000000001000001000010000110000001001000001000000000000011000100000010000011000000000000000
00000000000000011010000000100000000000010000000000000110001100000000011100100010011000001001100010000
01100000000010000110000100001010010000010000000100100000000000000100001010000001000110010010011101100
00000100000000010000000100001000100000000010000001100001001110000001000001000000000000010000000000000
00000000100000011000000000000000000010100100000000000000100010100000000000100001100000000000000000000
01100000000010000000101100000000000000000000100000000000001000000000000110000010000001000100001001000
00000100000000100000010001000000000010000100000000000000000010011000110000101000010000001000000000001
00000011000010000000000000010000000000100000000000000100000000100000000100000001000000010000000101000
00000000001000000000000001001001100010000100000000010100100000110100001101100000100011000100010010110
00000010000011000000010000001101010000010001000100010000100000011010101001100010000100001100000001010
00000110100001100010000100101011110000000010000101000000000001100000100000010001110100000000000101000
00001100100010000000110001000000001100010001100100000100010000000001000010000000110000010000000000100
00000000001000010000000000000000010100001001100000000100000011011000000000010000000010000000010000000
10000010100000000000000000100000000100000000000101001000101001000000001000101010000101000000100010000
00000001000000011011001010000000110100100000010000000001110000000100001000000000000010100001000000011
01000000000000001001001000000000000010000000000000001000000000001000000000000000101000000001000010000
00000001000000000000000000000000100000100001000100000100010101000000000100010000001000010000000001000
01000000000000100000000001100000000000000100000000000101000000001010000100000100000001000001001000010
00000000010010000100010000000000000001000000000000010010001100000000000011000000100010110100100000000
00010000000000100001100000001000000001100001100101000001010000101000000000000010011000000000011000000
00000010000000100100110000101001000000000010100000100000010000001000001000000100000000010100000010001
10011101000010001011010110000000000010000100000011000100110000000000000000000110000110000001000000000
01000010100001101000000000100000000100010001001000000000000100000001000000000010001000000000000111000
00000000001010000000010001000000010000000000001000000000100000000000000010101000000100000000000001000
00000000000010000000101000000000000000100110000000010101000000100000000000010100011001000001100000000
00001100100110010001000010000000010100000001000000000000000000110000000000000100000000000001010000111
00110000000000000000000001010010000001000000000000000000110001100000100000010000000010000000010001000
00000100000000000000011000000100000111001000000000000000100010000010010000000000000000100101000000000
10000100000101000110000001000000000100011001100000001001000000000100000000100011000011000000001000011
10000000000010100001001000001000011000001011100010100000000000100000000001000000000000101001101000100
00010100000001000000000000010010000001100001100001000011010101001000001000001001001000000100001111100
00000000011000010010000100110100000110100100000011001011000000000000000000000010010010000001000100000
00000001000001001000000011001001010001010000000010000000000000000100000000000000101000100101000000001
00001010000000100000100000000000001001010001001010000000100010000000001001001000010100000010000000000
00010000000000000000010000100000000001001000000101000001010010000000000000000010000011011010000010000
00000000000000011000010000000110010100000000001001010000011010000001100000111000000001100001000010000
00000000001000000001101001000100000000000000000010110000000001001100111000100000000001000001000000001
00000000000000010000000000000000011000001000000001000000100000000010001000000000000000000000000000000
