00000100001000000000100100011000100001100010000100001000011001000000010000001100000010000000000000011
00000001000000100110001000110001000111100010000000010010100101000110000010000000001010000100100001000
10100101000000000001000000010010000001100000001000110000000010000000000000000101000000001000011000001
00000001000010010001000000010000000000011001001000001010001010000100010100000000110000000001010110000
00000101000001000001000000100100010010001000000001000001110001000001000100010000000000010010010100010
00000010000000001000000000000011000010000000100001100000000010000000010000001010100000001100000110000
00000000011001000100000000000100000000010000000101000000100000000010000000000000000000000000100101001
00010000001011110000000100000000000010000000000000000000010000010000000000000000100000110010011010000
00000000000010010000000010010000100000000000001000000000000000000011000000000000000010100000000000000
00101000100011000100001000000001000000111010010010000000001001110000000001110001011000000001001000010
01110000000010000000000010001001010100001001000010100000001000000000000010000000001000000000001000001
10100001000000000000101000010000000010001010001000000000000000000000000100010000000000000110011100110
00010100000001000000100000100001001000100000100001010001101000100000000000010000000001000010000000000
00001000000001000000010000101000101000001010001000000100000000100100000000000000000100000000000000001
00000010000000011000000010000001100110000001001001000100000000010100000100000001000000000010100000010
00000000000000000010100000001000000000000000011000000000000001010001000000000001100100010001001010000
11001110000000001000100001110000000000000000011000000010000001000100010000000011000000000000000000010
00000010000010000100000010000111000011100000000011110000100010010000000000000000000000000000000100000
01000001000000101110010000000000100010000000000010001100000000000000000100100000100000000000001010000
00110000100100000100000000000100000100000000000100000010001000100000000010000001001010000110010001000
10000000011000000000011000000000010001001000010000011000000100000010000000100000001001000000000010001
10100000110000010011100000100011010100100000000110110001110000000000000010100001000000000000000100000
00000000000010000000101101010000100000100001000001000000000000000000000101000000100000010010000000010
00100010010000010100100000001000000000100101000000000000100100000000000010000000001000001000000000010
00010000000000001000010100000000100100001100000001001001010000000000000000000000100000010000000000000
01010000001010000000000100100000001110001000000001111110000000111101000001000000111000000000100000010
10110100000000000001110000011010100010000000000001001000001000100000000001000000000000000000100010000
00000010100000010000100000110000000000101000000001001000001001001100000000000000001000000010000100100
00000011000100000011010000000000000010100100010100000000010001000000000100010000000000000010010100010
01000001100110000000001100000000010010000100100000000010000001000100001000010000000000100100100010101
01000110010000101000000010000000010001000000001000001000100100011001001001000000001000000000000000001
00000000000000100000100000000000110010001010100000000001010001000001001000010010011000000101000010000
11000110100000000011000000000100000001010000000101000010000000100001100000010001000000000000100010100
11000000000001000001010001001001010000000010010010010000000000000000000000001000001010000000010011000
00100001000000000100000000101110101000001000000000100000001000100000100000010010101010000100100000100
01010000101001001010010001001101010000000001000000000011101000000000001000000001100110000110000000001
00001000000100000001000000100010000000100000001010010000100000000000000010000010000000000010000010011
00000000000000000000000000011000000010000010010100001110000000000000110001001001100000010010000010000
10000010000000100000011100000000000000000000000010000000000000100001010000000001010000001110010000001
10001001000000100010000100000100001000101000000000000000101000000100000000000000000000001000000000010
10000001100000011000000000000000000000010110000100001010000000000001101000001011000010000000000000000
00000000000001100000000010000000000101000100000000000000010001000001000000000010000101100000000010000
11100100100000111000001100001000000000100000000000000000000010100011100001010110010010000010000001100
00000001000001000100010000000001100000010000000000010000100000000010001001000000001010000000100000110
01000000000000000100010000100001001000000000100000001100000000000000000000000000000000000100001000000
10101000000100000010000100100010001100010011000000100001101000010001000000000000000001001000000010000
00001100010010010101001000111000000010000000000001000010000010100000001010000000100000111000110000000
00000010001000100001100000100000000000000000000000000000000000000000010001000001000000000001001001100
00010010000000100000010001000000000000100000100010100010000110000000000001000011100000010000001110010
00000000000100001000100000010001000011000000000000100110000000000001001000000010100010000000011011101
00000100010100000000100001011000010001000100000000101000000001000001000001100000100000000000000100001
00001110000000100000000001100100110000000100000000001001001000000010000000100100001000001100101001010
00001001000100000001000000001000000001000000000000000001100000110000110010101000001001000000000000000
00001000000000000000010000010000010000010001000100001100000000000000010000000010000010000100100011000
00100000001000000000000000011000000100000000000000010000101001100000100001100001000000000010000000010
00000100000000010010000000000000010110000000001000000000000100000000110101000000010001100000000000000
00000100000010001000000000000000000000000010000010000010000100000010000110010000010001000000000000001
11001010000100000100000100000001000001000101000000010110011100000010000000010001000100000000010000001
00000000000110000000000001000000100000100000000000000000001010101100000000000010000000000000000000100
11010010000010000101000000000000001011001000000000000100010000001000000000000000001000000100001000000
00000001000000010000000010000001101000000000000000001000000110010000100001000000000000000000000000010
00110000000000000000000000010000010000001000000100000000000110000110000000000000001000011000000001010
01000000000000000100000010100000000001010000000000000100000001000000000000110011000000000010010000000
10000001000000000000000001000001000000100000100000000110000000000100000001100000000100010100010001001
01011100000001000100010101000000000000100000000100001100000001100000000110000000110100000101010100000
00000100000101010001100110000000000000010000000000000000010000000000100000000000000000000000010001000
00011000000110000000000100010000000000110011000100000000100010000010000000111000001001000000000000000
11000110000001000000000100000000011001000000000000000100000100010000001000000000000000101100000000010
00000000000000000010000000000000000011110000010000000001000010000001010100000000011001010000000000000
00000000000100001000011000000010000100000000000001100000010000000000010000100000000011000010000000001
00000000000000101100000000100100001100000001000100000101000100000001000000011000000010001000100000000
00001000000000000000001000010000000000000010100001000001000000110000000001000000000010110000110100100
00000000100000000100010000011100000011001000000000000001000100000000000001000000000010000000000100000
00000010100000000001001000000010000000000001010000001100100101000110000010000000001000010000110101000
01000001000100000000000000100000000010000000000001010000001000010000000000000001000000001001101011001
10011100000000000010000000000100000101000100000000010110001110000000010010000000010000001001000000000
00000100001000000010001000000000100000000000011001000000001001100000010000000001000010001000000001100
00100000110000000000000001110100010000000000000000000000001100100010001100000000010100100000000000000
00010100000100010100010000010010010000001000000000000110000000000011000000010101100000100000100000110
11000000100011000001001010000010000001000110001001000000100110000100001001000001000000110000000000000
00010010000000100000010100110101000000001000010001001000000000100010011000000011100000000001000100000
00101100000000000000101000000000000010001010101001000000001100010100001000000000000000000000000010010
10000111100101000000001000110000000100101000000010000000111000000000000010000000001000000000000000000
01100001001000000000000000000000010000100100000000010000001000000000000001000000110000010000001000110
10100000001001000001000000100010000001000010000000101110010010010101000000000011100010100000000000000
00001001000000000000110010000010000101011000010100010000011100011000011000001000000000000000000000001
00001010000001000001000000000000001000100010100000010001000000000100000000101100000011100000100010001
10100000100000000000100001000010010000100001011000000000010110100000110001010000010010000000000000000
00010010001000001000000000000010000000010101000000100101000001000100000010000001000000010100001110100
00000000000000000010001000101001000000000000000100000000000010000010000000010001100000000000101100100
10000001100000001000010010010000001000000000000000010100010010001000000000010000001000000100010000000
00000000000010010000100001000010010000000000000010000001001100010000110000010000001101000101100001010
00000000000001100000000000000000000001000001000000000100101001100100001000000000000000100000000000000
00000000001000010000010000101000000000000000000000000000000000000010000100101101100100000001000010000
01010010000100000000000000100000000001000001010000000000000000001100000010001000110000101000010001010
00000010000000100000001010000000000011100110001001010000010000001010000000000010000000000001100001100
00000010100001000000000110100101000011010001000010000000000110000010001000000000000001001110000000000
10100000000000000000000100010010000000100000011000101000001000001000000000100000000000000001010000000
00000100000000000000001100000000000000110000101000000100100000000001010000000001000000000000000000000
10101000000000000000100100000000100001000110000000000010000000000000000010000000000000000100000111000
10000001000100100000100001000010000010000000000100000100000000000000000000000000000000010100000100000
