00000010000000000000010000000000000000100000000000000000000100000011010000010100000000000000000000000
01000010000010100001110000010001001000000000000000011000010000000000000000001010000010010010010001001
00010000000000010010100000000000000000011010010000001010000010000010000001001010000000000000100000000
00010101001100000000000100010000000100001000000000010001010000000000001110000000100000000000010000000
00010000000001011000001000000000010100001000001101000000100000000100000010000010001001000000010001101
00100101000000010000000000000000100000000000111000000000010001000010000100001000001010000000000100001
01000000000100000000000000000000110000010000000000000000010000010010000000010100000000000100000000100
00000000001000001000000000000001100000100110000001000000011000101011001000101000001010000110001001000
01000111001100110001110100010000001000000001000001001011010010000100100000000100000000000100000000001
00000001010100010011100000000100100010000000000011000000100100101010000000010001000101000000001000000
10111000000100001000001000001000000000011000001000000000010001000000000000000000000100001000110001000
01100010000000100000011110000010100110100000100100001000000000000000001000000100000011110100000000000
00000000000000110000101000000100000010100010100000001000000000001010100000000000100110001100000000100
00001110000000000001000000000001000110001000000000010000000000100000001011010110001000000000000000000
00001101100001000010000101100000010000000001000001100100100000100000100000000100000000111100000001000
00100000000000101000010100000000000101000000000000100000100000000000000010000100001010010001010000001
00111001000010000000000000000000010000000010100001001000000000001001010000000000100101000000000000100
00000000000010010001000000010001000010000000001000000010100000000001010000000010010000011001000000010
01000000010000010000000000000000101010000000010010100000000010000100000100001101000000100000100011001
00000001000010000000010000001000010000000001000001000010000000010000000000001100000001000010010000100
00011010001001011001000010000001000000001010000000000000000000100000000000000000100110000000010010010
01000010000011000000000100100001000100010000000010010000000001100000000011000001000000010010000000010
00110001001000000000000001000000111000000001010000000000001000000010000000000000000011000000101010000
00000000000100001000000010010000100000011000100000101101010000100001100101000100000000010010001000001
00000010000000001000000011000000000001000000101010000100000110000100000000000010100100001000000000000
00100000000010000111000010011000001000001000010000000010000010000000110000001011000001001100011010001
10000100010000000000000100011001001000000000010000000000000000010000000010000010000000000000100100010
10100000011010000100000000100001001000000000010010000000000000010000010100000110010010000000001000000
10000010101001000100000000110000000000011010000010000000000001010010010001110000000100000001010000000
10010100000000000000000000001000000101000000000001100000100000000000000000100000000000110000100000101
00010000010000000011000000000000000000000000000010001000000000000010000001000000000010001000110000100
00000010000110000110000100000000000001010010100100010000000000000000100000010000000000000001000010100
00010000000000001000001000101000000000010000000010000000001000000000000000100000100010000000000000000
11100000010001000100010000001000000000000000010101000000000000000111100000001010011000000010001000000
00000011000000001000010000011010010000000001000001100000010000100100100100100100001011101000000000000
01000011000000000010100011010000000000100000000000001000000001100100000000000000011001000000010000011
00000000000000100100000000000000000000001100000000100000000000001010000010000000100000010100101000100
00000001011100010000000100100000000000000001101001000101011000000000010000000011011000010001000011000
00000000000000000000010000000000000000000011001000000011100000000011111000101100010000000000011001111
00001100010000001110000000000000000000010000000000000001010000010000000000010001001000000001010000010
00000000000001100100011011000001001001000100000000010001000010010011000001000000110001100000000000010
00000000100000100000000000010000000000000100001000100011110000000000000000000100000100000011000000000
10000100010001100010001001000000100000110000110000101101001000000010000000100000000000000000010100000
00011000000000000000011000101000010000000001010000000000000000000010000000010110001000001100010000000
00000101010000001100000000100010001000000001000000001000111100000001000000010010100000000010000001100
00000000000001000010000001000000000100001000000000000001001000000010110001000000100001100001000000000
01010000000101100000001110100010000100000100001000010011010000010000000000001000011000000010000010001
01000000000101100000000001010000010000000010001011000001000000000000000000100000000001000010000000000
00010000000011000101011110000000000010011000000011000000000000010000000001100000000000010100000010010
00000000000000000000000000001100000010000010000000000100100011000111000000000000000101000100101010000
01000000010000111001100000000001000000000100001000000001000000100000000001011110000100000000000000001
00100100100010000100000100011001100000000000100000010011001000001000100000100100000000000000000011100
10000000000000001000000000110000000000010000000010000000000000000101000000000000110100000000001000001
00000000000000000010100100000000000000000010010110000001000000000001001100000000110001000000100000010
00010100000000000000010100000100100000010010000001010101000100001000000010001000001000101010011110000
00010000001000000001010110000100000001000101001000000000000000100100000000000000000100000000000110000
00000010010000000000001001000000100110000010100000011000000000010001010100000000000000010001001000010
00000100000000001001100100000100001000000000000000100011010100000000010000100010000000000100001110000
00000000101010100100011000000010010001000000000000000001000000000101010000000001001010000000000100101
00000010000101000000001010000100001000000000000001001000000000000010100100010000100000001100001000000
00000000001111000010000010001001000001010010000000010100010001100000011000000010000010001000100111001
01100101100000000100000100000000000001000000010000100001000000000101101010000001000000001000000000000
01000000001000000010000100000000001000000010000001000000100000000010100010000000110000000000000010000
00011001100010000000000000100000000000000100100101000000000010000000000000001001000001000010000001000
00000000010000000001000000100000000000010011000001000100000001100010000000000000000010000000000000100
00000001001000100001000100001000000000000000000010001010010001000001000000010010000010010000000000101
00001000000001000100100100000000000100001000010000010100101100010000100000000010000010100000100000000
00000000010000000000100000000000000001001000000010000001000010100000100000000000110000100011000000000
11000000000100001000000000000100001100000001000000001000011101011000001000000000000010100000000100000
00000000000001000001001001100000000000010101000000001000000001000000000001010010000010000100000000000
00000000000010001010000000000000001000100000011000010010100010000011011000001000000000010101100000000
00000000011000001000001010001000001010001010000100100100000000000000101000000000011000000000000001000
10100001011000001000000100111000000000000000001000000010010100000000000000000000100010000000010000000
00000110000010110000100000000001011010010000000010000000000000011000000010000001000000100000100000100
01100000110000000000010100100000010000000010000000000000001100100000000001100100100000000000010001000
01000000100101000001100000100000000001000010001100000000000100011000010010100100101010000000110000001
00000110100000100101000000000011000001001000000100000000000000100000100000000001101001000000000000011
00100000000000100010000000101001000100010000000110001000000010100000000001110100100100001000100000000
00010000000000001000000000010100000000000000010000100010000000000001001000000000000000100001001001000
00000000000000000000000101000001000000000100000000001000000000001001010000000000000001000000001000000
01000110000010110000010000000000010000000010010000001110000000000000000000100000000101100100000000000
10001000001010000100001000000010000011000100110000010010001001000001000000001000000000100001000001010
01000000000000000010000000000001100010001010001000000001000100100011000000000000000000000000001000001
00100000000000000000000000000101001000000100001000000110000000000001100001100010001010000000000000000
10000000000010100001000000000000100101000000001100000000001011001001000100000000000000100100000100000
00000001001000000000010000010001000000101000101001000011000100011000010110000000000001001110000000001
10001110010000000100000000100000000000001000000000000100000000010000000100000000000001000101001000000
00001000100001001000000000000000000000001010000000000000011000000110000001100000000100000000100000000
00000001000000100000000000101000000100000010001001000000000000000000010000001001001000000000000001000
00100000100100001001000000000000010010100100000010001000000001000000001000010011001010000000101000010
00001000000000000000000000000000010001000010100101000000000000000011001000101000000000101000000000000
00000000111100010110001000000000001000111000000000010101001001000000000000000010000000000000100001000
10000000000000001101000010000000000000000000000000001000000100000110000000000000101000100000100010100
00000101000000000001010100100010000000000000000011000000000100010011000000000000100000000010111100000
00110010111101000100000001000000000000000010000110000000010001000000000000010000100000100000000000000
00001010000010000100001000010011000000101000000001100100000000000100000100000100100101010001000100000
01010101000000000000000000001000000000000010000010000000010001110000000000000000000001001000000001000
01000000100111001000001000010100001000110010010000001000100011000001000000000000100001100010000000000
00000000000001000101000001000010000000000010000001000110000000000010100000000100000000001101100000001
00000000000101001100010001011001000010000000000011110000010001000000000000011000000000000000000000100
00000000001100000010010000100000000001001000011010000000000001100000000000100000000000000000000000100
