00010001000100001010000000100000000000000000000011000010000100001010000110000000000000000000000000000
00000000010000100001000000001000101000110000000010000001001000100000000000000000110000100110100000100
10001000000010000110000100000000000001000010000000100011000010000000000000000010000000000000000001100
00001100001000000001010001000000000010101000100000000000001000000000000101101000010000000000000000000
00001001010000000011000000000000100000001000000000000001001010000100000000100000001010000001100001000
00000000101011011010000110000100000100000101000000000010000001000011000010000010100000011000010001000
10110000000100000001000011110010000000110100000011000000000000000010011100100000000000000100000001011
10100000001000000001000000001000000000100000110000100101100000001000101000000000000001000100000000000
01010000110000000010100000000010010100101100010001000010000000001000011000000000000001100101000000010
00000100000000010000100010100010000000000010000000010000000110100100010010001000100010000000001001101
01000001011100000100101000111001000000000000000101000000010000000000001000110000000100011001100110000
01010000000000011100010000000000000001110000101000101000100001000000001000000100100000000000000000100
00000000000100000000010001000100101100000000010000000000010101001000000000000000000001000010000010000
00000001100000000001000110000000001000000000000000100010000000010000001000010001000000000000000001000
00110010000000100010000010000000100000000000000000101000001110011100000101100010000000100100000000000
00000010100000000000010100000000001000000100000000000000110000001010001000000000001000000100000101010
00000001000000000001100000000001000001100100100000000000011000011001001001100000000011001000011000000
00000000010100000000010000100000010000101000100010001010000100010000001000001000000100000001001001000
00000000000010000100000100010100100000000001000000000000000001001100000110000000000100000111000100000
10000001010110010001001000000010001110010000010100000011000000000001001000000100100000100000000110100
00000000011000000000001000000000000000001100000000000000000000100000010110100000010010011100000110000
00000001100001000000000100100100000001000000001000000000000000100000000000110010001000010000010000100
00101100000011100000110100110000010010011000000111000000000010000000101000000010000000000001000010000
00000100000100000100100000000000000100000001010000010000000010000100001000000100100000010000110010000
10010100000000000000010001000000000100000100000010000000000000000000100100000010000010000000000001100
10001011000010100000111101000010010001100000001010000001000001001001011000000000010010010001100000100
00110111010010100001000000010000000001001100000000000000001000000000010010000100000000000000100000100
00010100000000000101000000010000000001000000010101100000001000000000110000000000000000101000000000000
01000001000100000000000110000101100010000000100010000000100010000000110000001100100000100001000000010
00101000100000001001000010011001000000010111100000000000100100000000000000100000000100000001000000000
10011101100100000010000001010000101010000001010100000000000000100100000000000010000011000010100000000
01000000010010010000000100000000010000000000001000000000110000000000010000100100000011010100100000000
11000010011000000000001100001001011000101000100000000100000001000110110000000010000000000100010001011
10000001000100100000100010000000000000010000001000000000100100000000000010010100000010000010001000000
01000010000100000000000100010010000100000000000100000010101000010010000000000000000001100000000001000
00010000001010000000001100000000001100000110000000011000110000000000100000010000010000001000010000100
00110101000000001010001000001010000001000000010010000000100100000010000011000000100000011110001000000
00100001000010000000010000000100100000001010000001000000000001100001000000010000001000000010000100000
00000000000000001001001100000000100000000000000100000000000100000010110100000000100000011000000010001
00000000001000010000101001000000010000000000000010010100000100100011001000000100101100000001100000000
00001001000001110100000000000000000000000010011100000011001000000001010000000000001001010000000110010
10001100000000000000100000010000001000000000010010000000010000101000000100000000000001100101000001000
11000010010001000000011100000100000000001000001010010000000110000011100000010100001001111001000000010
00010001001000011000001000010000000000010001000000010000000000000000000000000001100100000000000000000
00010000000001100000100000100000101110010100000000000001000001100100000111000000010110010100000000000
00100100001001000000000000000010010000000000010001100011001000000000000100001100000001001100000000000
10000000010000010101001100010000100000001000000101001000000000000100000000100001000000000100000010011
00101001010100000000000100100000001001000010000101101000100000000000100101100100000100011000000100000
00010000001001111000010000001111011001010110001000000000011000000000000000001010010000000110000101010
00000110011001100000100011000000100101001001000010100000001000010110000010010100000010100000100000001
00000110100000000000100100010101100000000100100010000000011000100100000000100100100011010000110111000
00000010000001000010010001000010001100000000000000010100000000000000011000000000000100000000010010000
00110000000001000000100010100000010010001100000100100000000000001000000100000001000100100100000001000
00010000000000000010000000100000110000000000000000000000000000010000000000010000000100000001000000010
10000000001000101101000010000000001000100100000000100000101001100000000000100000001101000000100000010
00000000010110000010000000000010000001000001101000100000000000001100000000010101000000000000000100010
00010000101000101000100001000010000000000010000000000000001000000100000000000011010001000010000010000
10001000000100000000000101000000000000000010001000100100001000000001000000000001011000100000000010000
00000100000000010100100000001000000000000000000100000010000001001100000000010010101000000000111000000
10110000000100100010001100000010000101000000001010010000000001000001000000000001000000000100000000001
00000010100010001001100000000010000001000001000000010000100000000101000000010000100000000000001000010
00000101000000011110000000010000100010000010000000010100000000000100011100000100001000000001100000100
00010001001000000001000000100000100001000000000000000001000000000000000000100001010000010000000100100
00001000001001001000010001001100000010100010101000000011000010000000000010000000001000100010000000000
00000000001100000001011000000000010000000000000000000100010001100000000000000010000000011000001000001
00000100000010101100010000000000110010000000001111000000000110000101000000100000001010001000010100100
01000000000100011000000000001000000001001000000101000000100000000000010000010000000000000000000001000
10000000000101010000000000000011010001000000001000001000000001100100100000000010000000000000000000101
10000000101001111000100000000010000001000100000100000001000010000000000000010000000100000010000000010
01011001010001010001001000101000000000000000100000011000000000000100000000000111000000010000100110001
00101000000000010000000000100000000010010000000100000000000000000100000000000000100100000100000001100
00100000000011000100000000000110010000000000000001001000100001000000100000000111011000000111000010001
10000000001000000000000000000000100000000001000010100010000110000110000000000000000001001000100000100
00100000001000000001001000100000010010000000110000000100000000000011000000000000001010000010010001000
00000000100010000100100000000110000001000001000010001100000001100010000000110000000000000101000001000
00100000100001000000000110000000011000001010000000000000000000001110000100000000100000000010000010100
10000010101001000000000000011000000010000110000001100000101101000000000000000000000100000000000110000
00010001001000000010000000100010000001000010001011000010010000000110000001001000000000000100010000000
01001010001000100000100000100000101001001000001001000000010000001001000000000000000101010010000000110
00010000000000011000100000100000000010000100100000000000000000110000001000000000001000010010110010001
00000010000000010000010110001010000000000000000100000000000000100100000010010100000100001010010000000
00010000001010000000000000000000000100000000000011110101000000010001000001011000000000000000000000000
01000000000000001011000000100000011100010000000100001100001010010000110000000000000000000001000000000
00100000010000001000000100000110000000011000000000000000010000010000000001000000010000000000000000100
00010000000100000000000100001000001000000000000010000010000000100011000010001000000000000001100010000
00000000100000000000001000000001000010001000000000100000001000010000000001000001001010000011001000010
00000101010000100000000011000000000001100000000000010001010000000000000000000100001000100010000000010
00001000001010000101000011000000000100000000000000000000000100000000000000100000000000001000001000000
11001010011000000000000000000000000001010100100000000001011000000001000001000001000100010000100000000
00000010000010000010000101000000010000000000001011010000001101000000010100000100100000000000000100000
00000100000000000001101100000100000100100000010001011100000000000000000000100001000000001000000000000
10000000000001000000100000101000010000000000010000000000010001000100000000100000001000110010001000000
00000100000001000000000000000000000001000110010100000001100100000111100101100010000101110100000000010
01110100001101000010000001001101000000000000000000100001010000001000110000100000010010101001000000100
10010010000000001000000000000000000000010010000100000000001010000100010101000100000000000000000000110
00001000000010000000000000000001100000000110110000000000001011010010010000100010100000010000000010000
00000000100001100010000000000000000000000000000010010100000001100101000000001000000000000000001001101
00000000100000000000100000010000000000000011000000010000000010111000000001011010100000000100000000110
01000000000100001010000010011000000000010101000010100000000000000001010000000000000000000111010010100
00001010000000000000001000001000100000000111000000000010000000010000000000010010000000010001010010000
10001000000100000011000000001000000000000000000000001010001000000100101000000000000100000000110000000
