00100000000100000110101000010000001000100000000000000000001001100001000000100110000000010111000000000
00100000001110010001000100000100010000010100001001010000001110000000100101000000101010000000100000010
00000001011100000000000000011001001000100000000000000010111001000000000000001000010001000000000010000
00000011000100100001010100000000000000000000000000100001010010001101000000010000001000011011000000000
00001000001000101101010000000000001010100000000000000100000000000000000000000000110000001001100100001
00000000000000000000100101010000000000000100000000000001000000000010101011010100110000000011000100000
00000000000000000000000000000100000000010000000010000000001100001000101000001100010001000010000000000
00000001001000100000000010101101100000011000110000110000000000000000001100010000100000100100100001000
00000000000001001000010100001001100000000100000011100000010000000010000000010000000100010100100100001
00000000100000000000010010001000000100011000000011000000001000010001011000010010000101000000001000011
00100010010001000000000000000010000000100000001000010000010000100000000000100000010000000000000001001
00000100001001001100010000000000000010000100001000000000011010000000000000000000000000010100000001000
00010000011000000000110010000010000000011000001100001000010000100000000010010000000000001010000000010
01101010001001100010000000000001000000010000000000000100001011011000111000000000000000000000000000100
00001000010000000010000010001000110000010010000000110000000000000100000100110100100000000011110000010
01100100010001000000000010000110000100000000000001000011000000001000110000000001000010101000100001000
00000010001000000000000001000000100000000000000000010000010100001100000000100010001001000010100100110
11100000100000000000001001001000010000000000000000000000000000010000011110000000001000000000100011000
10000000100000100001000000001000001000011000100001100000000100100101000100010000000000101000010000100
00000000001000100000000001000011001000000010000010000100000010000100000000011000000000000001000000000
00000100001110000000100001000001000001000010000000000000011001100000101000001111000000010000000001000
00000000000100010000000101010010000010000000000000000001000000000001101100101000010000000101100100000
11110100000001100000000000001001101000000110001000010000100000001100001000000000000000101010000001000
10000010000010000000000000001010100100000000000000001000010000001000000000000000000100000100100000010
00100001000000010010000000010011010000000000000000000000000000101100000000100100000000001100100000010
11001011000000000000001010000001110010011000111000000000000000000000000000010000000000000000000100100
01110000000100001000100000000110000000000001000000000010000100000101010000001000000000010100000000000
00000000000010100010100001101000000000010100100000110100000000000001000000110000101100000010001010000
10000001000000010100000000001000000000000000000110100001000000000010000000010010001010000000000100010
00000010000101000000010000010000000000000110100001110000000010000010000000001000000101000000101000000
00000000000100000000000001010100000110000000000000001000000011000001000001000010000000010111000000010
00100010000001000001001000100000000001000000000100011000001100010000000001000000001000010101000000001
00000001000000000100001001001000000000000010100001000000000100001000100100000000000000000110010010000
00010000010100001000000000001000100000000000000000000000000000000000000000010010000001001000000000000
00000000100100000101000100000100010000100101000000001000000010000000000001000011100110000000001000111
00000000000001010010000010100000010000100010010000000010000000000100010001000001000110000000000010000
01000100100000000100000000001000010000001000011100000101000010000000001110011000000000000001000100000
10001000000010000010000000000000000000000000010100100101100000011000001000000010100000000011000000001
11000000000000000000100000000000100000000100000000011001000000101000000000001011010000000000100010000
00000010000110001000000010100111000000010101000000010000001000000010000000100100001000100000000000000
00000100000001000100100000000001000001100000000100000000000100000000101101010010000000010000000000011
00000001000101000000010100001001000000000001000000100000000000010110000000000001000000001000101000000
00001000000001101001000000000000000001000000101000110010010000000001000001100001000000000000011000000
00000000011000010100000000000101000001000000000000000000100100000101000100011000000000000000000100001
00000100100001010000010110100000000100101001000100100010000100000000000100001000000000000000001000000
00010011000000000000000001000110000100000000001000000010000000000000101010000001000000001110000010001
00000000000011100000000101000010001000000000000000000000000100000000000001100000000000000001010000000
00000100000000000000100000000010100100000000000000000000000000100000000000100000000010010000000000000
00010101000010000000000000000000000000000000000001000001100001000001000011100000000101010110000000100
00100000000000001100000010000100000000000010010100000000000000110010100000000000000000000010000000000
00100110100000001010000000000110100000010000010100000000001010001000000000000100101000000010001000000
00000001000010000000110001000000000000100000000001010010000000000000100001001000000000011010011010000
00001000000000011000000000000100000000010100000000000001001010000110000000001000000000001100010100000
00000100010000000100000000000000010000000000000010000000100011000000000001000001010001000000000000000
00000010000000100000000000000000000110000000000000000000011010000000000000000001100000100000001100100
00000001000000001000101100000000000101001000000010000000000000001010101000000100000010000000000100000
00100100001110011000010001000000100000100100010000000101001110001000000000000000001100000010001000010
10001000000000100110100000000100000000000000000000001000000000110000011000100111000001010000000010000
00000000100010000010000000010000000000000010000000000010000010100000100000010000010000000000010100000
11000000000000000000000000000000100000100000000000000010000000000101000000000000000000101011000000101
00000000000010010000000001001000111100011000010010000000000001000000000000000100001000011000100010000
00001000001010000000010101100100010000000000010001000000000000011110000100011000101000010001001000000
00001000000000001000000000010110000000000000000000000000000000000000000100100001000010111000001101000
00011001000100100000001011001010000000000010000000001001001000001101101110001000101001100000000000010
00000001000000000000000000000000000100100000000000000000010011000001000000100000000010100000100000000
00000001000001100010010101001000001010000000000001010000000000000010010100000000000001010101001010100
01000000100000110000000110000000010000010000000000000001000000100000000000110100000000000100001000010
00000100010010000111000010000000000100010000010100001000000100100001000100000100000110100010110000010
00000010010011000000000010010000100000000000000010000000000000000000000000000100100000011000101000000
00000100010000000000000000100010000000001001000000000000000010010010000000010000010001000000000000100
00000000000100001000000000010000000100010010000000000000000100001010101010111000010000001010100000000
10000100000001010000001100000010100110000010010000010011000010001000000000001000000000000000000010000
00000000000010000000000000000000001101001000000000000000010100100001010000000000000000000000000010100
00000101000010000100010000001100001000000010000000000101000001000100000000001000011001000100000010010
01000001101000000001100000000000000001100001000000100000000000000010001010000010000000000000100000010
00000000010000001010000000001000000010100000000000000110001100000000001000010000000010101000000001101
00000000000010000000000010000010000001100000010000000000100000000000000110000000000000000000001110000
00010000010000000000001011000011000001000001000110011000010000010000000001001000010000000000000001001
01000000000000000001000000100000010000000011000100000000000000100000001000100001000110101010001000001
00000101000100011000000000000010000000000100010000000010010010000000000001010000100000000000110100101
00000000000100000100000000011110000000001001000000100000100010000000001000000100001000010000000001011
00000100101100000010000010000010000100000010100001000000000000100100100000000000001000000000000000000
00000000000000000001000000000001010000000001100000110001001001010010000001000000000010010000010000101
00000010110000000001000000010000000010000001100000000010100000000000000000010000000000000110000010000
00000010000001000000000000000000100100110000000010000000000000010010000000011100010001010000010000001
01000000001000000011000010100001000111100110100000001000000010000000000000000010100000100000000000000
10000000000000000000000101001000010000001000000100000001001100100000010000100000000011100000000000010
00110100010100000100000001000000100010000000000000000000000000000001000000010101000000000000010100000
00101100001000000000000110000001110001011000100000011000010000000000000000000010000000000000000011100
00010001000000011010010000010000000001000000010000000000001001000100100000000000001110000011000000010
00000000010000000011000001001000000000100001000011010011100001100010000000100100010100000001000000000
00000010100000000100000000010000000000000000100000010000100100010000011100000001010001000000011000000
00000000000010000000000001000010001000010010100000010000000010000001000000001000000000000101000000000
00000001000000000100000000010000001000010000000000000000000100010001100000001000010000000100010110001
00000000000001100100000000000001100000001000000010000000011000000000100000000100000010001000100000000
00000000001000000000001000001000000110100000000000000000001000000000010000000000000100100000000001001
10000000000001001001110000000000000000001100000000010000001000000010000000011000000000000000000100000
01000100000000000010000000000100010000000000000000010000000001000000100011000000100000001000000000111
00011000000000000001000000000100000000010100000000000000000000101100001010100000010100101100000001000
01000000000000100101000000010010000000100100000000000000100000010000000001000100001100000000000001000
01000101101000100000000000010000100010110000000000000000001000000000000100011000000001000000000100000
