00000010000000100010000001000110000000001000000001000000000000000000001001000110110100000001010000000
10000011000000001100000000000001001100000000000001000010000100100000000000100100110000000101010000000
10000010000000000000100010000010000000000000000001000000000000000110000000000000001000000000000000000
00000000000000000001100000001000000010000000000001000000000000001000001000000000000100000000000000000
01010000000001100000000001000010010001100100101110100000100001100000100100000000101010000010000000010
00001001001000000111000000000000000000010100100001000000000001000000000000010000010000000000000001000
00000000000000000000110001000000100000000000100100000000010000011000000000000011001100100001010100001
00001001011010000110000110100000100000000000000000000000000001000000010001100000000000000010011000100
01000000000000000100000010010000001000000000010000000001101000100010000000000000010000000010000100001
00110011000000000000000011000000000010001010000100100100010010100010001100000000000000001000000000000
01110001000000001101000000000000010101000000100001000000000000111100100000000011000001110000000000000
00000000000100100111000000001001100001010001000110011000110100000110000000100000000000100001000100000
00100001001000010010000000000000000000000100000000000010010000000000000101000000000000010000000000000
10010000000000100000010000000000000001000000010100000000100010000000000000000000010000001001010000001
00000100000000000100100000000010010010000100000000000111100000000011000010100010110100000000000001000
00000001101100101001000001010000100010110000000000101000000100001100010000000100001000000000100011000
01000000001011101100010000010000000101010000010000010111000100010101000000000110100000000000000010001
00000000000000000000100100000000001000000000010100100001000000000001001001000100000010000010000001011
00000000000100100010000000010000000000000001101100000000001000000010000000000001000000000000110000001
00000000000000000100000000000000000100001000001001000111011010010000000110000000001110000000000000000
00001000001000100110000100000000000010001000000000010000000100000000001000000100000000100001000000001
01000010001000010000000000000110000110001000000000000001011000000010000000000000000000000000010110000
01100000000000000000001000011000000001000010000110000010010101000000100001001000010000000000000000000
00001000000000110000010000000010000000000000000010111000011000000100000000001110010001010000000010000
10000000000000000001000000000000000000000000000010000011000110110000000000000000000000011000100001000
01111000000000001000000010100001000000001000010010000000100000000000100001011000100100000010000010010
01000011010100110000000001000000000000000000000110000100000000000000000001110000000000000000000000000
01000000110011000101101000000100000000000000000111010000100000000000000000000100010000010000100010000
10000001000010001101001000000000000000100000100000101000000110000100000000000010000010000110010000000
10000000000000010000000110000100000000010011100100000100000001000110110000000000000000001101000000000
00000000010100010000001001100000100000100001010010010000011001010000000011001000000000000001010001000
00000100010101001100000000100010000001010100000000100000010110001000000101100110000010100000010010001
00000000000000111010000000000010000000000000110000000100100000000010000101001000000110010000001000000
00010001000100000000000100100000000010010100100011111000000000000000000000000000000000000000000001000
01111000000100101000100100100000011000000000000000000000001000100010100010000000011010011000000110000
00101101000010000010000100010000101000000011000000001000010000100001000001101010000101100000010000000
00000000000100010000000110100000000000001100110000000000000010000010010010000000000000000111000001100
00000110001000011000010001000000000100000100010100000000010000000000100000010000100000001000000000000
11110100000010000001000000000010000010000010001000000100100011000000000100000000100000010010000000000
00000100000000001000000000010000010100110001011000100100010001010000100000000000000001000010000101000
00100000010100000001000010100000100000000000000100000000000000000100000000000000000000001001000000000
00000000111100000000010001000000000000010010000000000000000000000000000000101000010010000000000000000
00101001100000000000000000001001001010110000000100100000001010000100010000000001010001000100100000110
10010101010000000000000000000100001000101100000000100011000010000000001000000000000001110000000100100
01000000110010001010001100011000000000000000010011000000000000110000000000000000010000000000010000100
01011000011100001001100111100100000000010000000000000100000000011000100100000000011001000001000000000
00000001000000001000011000000000000000000000000000010000000000000000100001000100100000010000000000000
01000000100100000000110101000010001000000001000000001100000100010000000100010000001100010000010011110
00100000001000001000001000001000000000101000010101100000010100000111000000100110100101000100000000000
00001000101000000011011000100000000100010100001010000000010000100000001100000001010000010000000110100
10001000000000000000000100001000000000100000000000000000000100000110010100000000010001010000001100000
00001000000000000001100000101010101000000000000100000010000000000000010000000100010101000000000000001
00010000000000101000000001100000000001000110111001000001010011000011000001001000000101010010011100100
10000000000010001000000000010000000010000000010000000110000000000010010000010000000000001101101000000
00010000000001001010010000110000000000100000000010011000001000000000010001000000001000000001000000100
00100000001001000100000100000000000000000011000100011001000000011000001010000000000000000000000000000
00001100100111000110001000100000001100010000010001001000100000101000000000000000011000000110000000000
10101010000010000100111000000010000000000001001000010010000010000001100101000000100000011001000000000
00010000000010100100010000001100000100000000000010000100100100000000000000000010000000000001000000000
00001010000001000010010001111001000001000000001000010110001010010010100000000000000010010010000000000
00010000000101000100000000001000010000000001010000000001001000000011000110000100000000100000000101010
00010001000001010101000000010000000101000000000010000000000000010000000000110100001000000000000100001
00000000000010011011011001000011100100100000000001000000000000001000001100000000001000000000100100110
10000000010100010000100010000100100000000010000000010100010001110010011000110000000000010000000000001
10001000000000101000000010010010000000000000000000011010001111000010000100010000000000010011001000001
00000100001111000100001000000010100100001100010000100010000110000100001000000000000011000011100000100
00000100001000001000010000010000010001110000000010000010010000000001100000000101001000001000001000000
00000010000000000000110000010000000010000001000000000000010000100000100000000010010000011000010101100
01100000100010101010000001000000010000010000000000000000000000000000000000100011000001000000001000000
10100010000000000010110100001000000100000001000000000110000000010100010101010011000000000100000000000
00001001000110100010010000001000011000100101010100000000000000010110000000000000100110100000010000000
00001000001101100101000000010000101010100010000000000000000000010001000000001000000111100000000000000
10000000000100100100010101010001011000000010100000100000000010010000000000001000000000101000000100001
01000000000010000011000000000000001001000000000000000000010000001001001000010000000011100100000000101
10000000001000100101000001010000000000000010000001000000001000000101010001000010010000000000000000000
00001000000000000000010100000100110010010100000100000011000000000011000000000000010000010000000110110
01000001100001100000000111010000000010000100100000000110000001000100000010000001000010100000000000010
01000000000000010100000000110000000000100001000011100001100000100001000010001000000000000000010100000
01000000010010000000100000001000110000110000000000000000000010000000000000000000100000011000010000100
10000010000010001100000100000000000000111000000000100000000000100010000000101000000001001001110000000
01001000001001000100000000100001100000001000001111100010000001100000000100000010000100000000000000000
01000000000010000000000000000100000000000010000000000000010010000101000010100000100010000001101001000
00000110100010000000000000000000000100000000001000110000000100001000000011010000110000000100000000100
01000000111010000000001000000000000001000011000010001000100001001000000010000011001111000000000000000
01000000000000000000000000010000000000110001001010010000001000000000000100010000100000000000010000000
00000100000100100000000000000001000000010100000000001000000001000001101001000000110011000001000000100
00000000000000000010000100010100011100000010000000101010010110000000100001000000000000000000000010010
00000010000000110010001000100000001000000000001000000001000100010010000001000000000000000000110101000
00110000000000000100000000101000101101010110001000000000000000000000000100000000100010100000001000010
00000001010000000000000000000000000000100000000100000000000010000000000000110010100000000000001010000
10100010000000000011000000000000001000001000000000000000010100000000110110000000010010100000000001000
00000110000000100010000110000000000000100000100000000101100000001000000010000010001010000011001000000
10010001010100100001000000000000000010000000110000000100000000000000001010000000100100001000110000100
10010010010000000010000000000000000001010101000000000000000000000000100000010001010000000001000001010
00000000010010000000010000001111001000000010001000001010110001001010100110000001000011001100001000000
01000001110000010000010000110111000010000010000000000000011000001000000000000101010000000000000001000
00000000000000000000000000000000001000100000100000101001000000000100010000100000001000000000000000000
00001000000010010100000000000000000000000000001000000000110000100000000000000000000000000000000000010
00000000000010001101001110100010100000100000100010101001100101100010100101100000000000000001000000010
01000101010000100001010010000100110000000100000000000000000000111000010001010000000100000010100000000
10100000101110001000011000000001000100010000011010000000000000110100100000100000101000100010000000000
