00110000000000010001001000001000000100000000000000100100001000110000000000000010001100000000000101010
01000000100100000100000000100100000100000000000000101000000000000000000000000001000000100101000000000
00100000000100000111001110100000000010011001000000001001000000000100011000000100000101000001000000001
00001010000000000000000011000000000000000000101000110000000000000001000000000000000011000000000000010
00000001000000100100000001100000010000000001000110000000010001000010001010000000001000010000001000000
00000000100100100000000001000011000000100000000000000000000010000000001010010000110000000000000001000
00000100000000001000100000100100000010100000010001001001000001010010001000100100000000010100000000000
10010000000000000000100011000010100100000101000000000010000000100001000000000000001111000000010000000
00000000001001000000000010000000010001000011010010000001000001000000100100000000000000000101100000000
01010000000010000010001001100100000010000100000000100100000000000000100010000000000100000000110001000
01001000100011100000000000000001000000000000000000100000001000000110001010000010000000001100001000001
00000000011110000001000000000000010100000000000000000000000001100000000000010100000001111000010001000
00000010010001001010000100010010001000000100000100000001010000000000000000101000000000110101000110000
00010000010100010000101000010000000110111000011010000001000000000100000000000000100000000000000000000
00000000000100011010000100000010000100100000000000000100001001100110110110000000010010001000000010000
00100000000100000001000000011000001100000010010000001101010011001100001000110000000010000000000001000
00000000100100010000010100100000100001001000001000100000000000000001001000000000000000000000010010000
01100000000100000000001011000100001010000000011100000001001100000000001000010100001001001000000000000
11000000000000000100000000000000001000011010001100000000001000100000000000000110000000000010000000000
10000000001100100000010010000100000000000000101000000000000100010000001000100000000000000001000001000
00000000000100000001000000000000000000100000000010000000110000000000010010000000010000010000100000000
00101100110100010100000000001000000000001110000100000000101000000001011001000100001000000000000001000
00000010001000010000100110000100000000000000000110100000100000000000000000000100101100000000001000100
00001000100110100000000010000001001100100000100000010000010000000001010100101000001100000100001000000
00100000000000000010000001000000100010001000000000000001010000011000001000000000000000100000110000001
00000100010000000000001000010011000000000001000000010001000000000001010000000000100000011010000001010
00100000010010000010010001011010001000000010000100000000000000000000100000000000100001000000100000000
10001100001000000000000000001001011101010001101000100100100000000000001000011010000011000000011001000
00000001100100001010101000000000010110100000100100000000000000110110000100000000010000010000110001000
00000000100000000010111000001000100000100000000100100101000001001100010001000001000000000000100100000
01011100000101010010000010000010001100000010000001000000001000000000000000000000001000100001000001000
00000000001000000000100000000110000000101000001010000000000000000100101000010000001000000010110000010
00000000000001100010000000000000001101010000000100100100011100010000000000110000000000100000010100010
00001100000000011010000000000000010101001000011000101000100010010100000100000000000011100000000000000
10000000010011000000000001000110100000101000001001000000000101000000000111000000110010000000000010001
00000000110000001101100101100100010100010000001000000010100010101000000000000010000000001000000001000
00010000100100101000001000001000010101110000000100000000011001000010000100010100100000000000000000001
00000000001000100000001000101000000000010100100100000010010100001000000000000000000000001000000000000
00000000000010010000000000100000010000000010100000000100100100010000000001001100100000000001000000100
10000100000000000001000000011100000101000000001000010010000110010000001000000000000010000000000000001
00100000000000010100000000001000000010000001000011000010000000000000000000100000000000000011000010010
01100101110001001000011000011000000000010111000010101000001000100010010010000001000101000010000000010
00100100000000000100010100000101100000001000000000000000100001000100100001000010010100101010010000000
01000100000100010000000000100000000000000000000000010000000000100011100011010101000000100000000010110
00000001000000000000000000010000000110000000001000000000001100000000100001000010100000110001000001000
00000000001110000101000001100100000000001001000000100001110000001000000000100000010000010110010010010
10000011011110010010000000010000000000001000010000001100010000010000000000000000000000010000000001000
00001000000001010000000000100000000010000000010000110000001010000000000000100100000001000000000000100
00100100011010000100101110110000000101100011010000010000001001000100000000000000001100000001000010000
00000000001000100000000000011000100100000010010000111010110000001000000000000111010010100000001001000
00000000010010100000100000000000001000100000000000000000000001000010000100000000000011100000000000100
00010000000000100001000001000000000100001000000000000000000000000000101000000000100001000100000100000
00000100000001000010010000000100001000000000000000100100110001000100001000000000000000001000000000000
00100000000000000000000100100010000000000000000000000000100000000000000001000100010010000101010010000
00100000101000010000000000000010010010000010000010000000000010000100101001000000101000101000100000000
00000010000011001000000000000010000000101000000001000000001000000000000000000100110000100000010010000
00100000001000010100110000000001010010000001000000000000000010001000011000000000000000101000000100000
00010000010000000000000010100000100000001000000000100000000000100000000010010000010000001000000000000
00000110011100000100010000000000000010000000000010000000000000011000001000001000010010000101000000000
00100000000100000010000000000000010100000010000000100010000100010100000000010000001010001010001010000
00000000000000000000000001100000000000010000100000000000000001001000010000000000000001000001000010000
00010001100000000001000010100001010000000000000000000000101111011100001000000001000101000010100000000
10001000001010000000000000000000010000001000000000101000100000001100000011000100001000000011000000000
00100010010000000000010000001100000000000000000000000101000111000000000011001000000000000000000011010
00000000001111100010000000000010001000100000000100000001000001100100000100000000001000000010000101101
00000001000000000000010010000000000000001100000000000000001000000001000000100000000000011100010000000
01001000000000001000000000000001000000000000000000000000000000100010000100000000011110000010000000001
00000000100000100100000000100100001001000001000001010000010001000000000100001001000010001010001000000
00101001000001101000010100001000010000001000000010001100000010000000000000000100000001100101100001000
00110000010000110000000010000001110000000011000100001010011100010000000010000000000001000000000000100
00000000000000000000000000010001000101000100000001000000100000000010000000000001100100000000010100100
00010000000000001000001000010000110000001000100100000000100010100100000000000000000000000110000000100
00000000000000010000001001000001010000000010110011000000011001000100000110000110000000000000000000001
00010100000000000000000000000101000000100001001000000010000010000000100100100010010000000010000000100
01110000000010000000011000000010100011000101100100000000000000010000001001000000000100000100000001010
00001000000000000001000100100000110000100000001000000100101000001000011000000010000100000010000000000
00010100010001000010000100100000000010010000000100000100001000000000000000001110000000000000001000000
00010001101001001000010000010000100110000000000001000001100000000000000000000101000010000010000000000
00000010000100000000000100000001001100000011000000000000000110000001010000100000000000001000000000100
11001100000001000000000000100100000000000110000011001000000101000000000100000001000100000100101000000
00000000000000000000010011010101010000010010000000100110000010000101000000110010000110010000010111000
00001000010000010000000000111010000100000000000011110001100000010000000101110000000000000000000000100
00001000010100001000000000100011000000000010000100001010000001000010001000001000000010000001100000000
00110000010000000000100000000000000000000010000000100000000100100001000010101000000001101000000111100
10010000000000000000000001000100110100000000000000010000000001000000000000000010000001100010100000010
00011000011000100000000101000001001000010100100000000000001000100000100010000001010000000000001000000
10000000100100000000010010001100010000000010001001001000100000000000110010000000010000000000101000000
10100000110000110010010000000011000000001000010000000000010000000001000000000000000000001000000000000
00100000010100000100100011000000000000011000000000000000100000000000000100011000000000100010001000010
10000010000000111000000000010100001000010000010010000010010110000110000000001000000000000000000010000
00000001000100000010100000000010010000001010011100010001000000101000100000010000000100000000000001000
01000010100000110000001000000000010000000100100000001010000000100000000010001000000000000000011001010
10011001000100001001000000000000000100000000000101100100000000000000100101100001101001100000000001000
00100100000000010101001001101100001100000000100101000000101010110000000100000101000000001000000000000
11110000100010001000101011000000100010110000000001000000010000000100000000000000000100000011010101100
00000000000101100000000100100100000000001001000100001000010000010110000000001000000000000001000110100
01000001000100000110100010110000101000010000110100000101000000001001000100000000100000000000000010001
00010000000000010010011001000000010000100000000000001010000000000010010000001000000000000000000010000
00000000110001010100000000101000010001010000000000000000100110101000100000001110000000000100000000000
00000000000101010000010000001010100000000010001000010000000000000001000000000000001000000000000101010
00001010000000000000000000001110000000100000100000000011000000010000000000010001000000100010000010000
