00000000000000000010000000100000101000011000000000011010000010100001000100010000010000000010000000000
00000000000000100001010000011101101001000001001000000100000000000000000000100000000000000001000000111
00000000000000000000000000001011010001001000001100000000010000000000000000011000110000100000000100000
00010000100000000000000000000001000001101000000010000000000100000110000001000000000000000000000000000
00100000110000100000010000000001000100100000000000001000001000100010000000000000001001011100000000000
00000000010001000000000000000000010010001010000101100100000000000000100101000000010000000001000011000
01000000000000000000000000000100001000000000001000000000001111000101010100110010000000100000000000100
01000000110000000000101000000000001000000000000000000000110001000100011000000000000010100000010000000
00000001100001100000000000100101000001000000010001011110000000010000010000101000001010000100000001000
00000100100000010000001010000000000000010001001100000001000010000011000001000000001000100000000000100
01000010010010000100000000000000000010000000000000000000000010000100011011000000000000100100000100000
00000011000010000000000000100011001000000000010000100000000000000001000100000000010010010001001000110
01000100010100000000010000000000100000000000010100001000000000010101000001001000010001000100000001100
00000001100011001000000000101000101000000100010000010000001000000000010001000000000000001000010000000
11000110101000110011000000100111010000100000001001001000000000000110100000000001000000000010000000000
00000110000001000111001000000000000001011010000100110000000000000000000001011010000000000000010000010
00001000000000001000000010100000000010000000000000001000100000010000000000100100010000010000000101000
00001000000000100000010011100110000010000000101000000100011000000000000000000000010000011000000000000
10000000000000000010001000001001110000001001100100111000010000000000000000011000000000010101010011000
00001000100000100000000000101000110000110110100011000001100010000000101000100000000011000001001010000
00000100110000110000010001000000000000000000011100000000000000010001000000010000000000000000000100010
00000000000001000000000010000000100100000000010001000000010000100000000000000000000101000100001001011
00010100000000000110000000000000000000000000010100000000010100000000000010000000000001101010000000100
00010010000001000010000000000000000000101010000000010000001110000000001100100100000000000111100000000
10000011000001000100001000010010000010010010000100001100100000000000011000101100000000000000000000110
00000000111000011100000000010000000001000011000100000000001011000000010000100011000000001001000100000
00011100100110010010011001000010000000111000000010011000110000100000100000000110000000001000110110000
01000010000011000100000001000010010000000000000000000100000010001001000000010100100000001101000001100
10000000001000011000000001000010010000000000110100001110000110010101010100000101000000000010100000010
00000001000000000000001001000000000000000000000001001100000000000000000001000000000000010010000001000
00000000000000001000010000000000110100000000100000000100000000000101100000011010100001100000001010001
00000001100010000000000100100101010100000001101010101000000001000010000001001010000001100000110010000
00000100000000000010000000100000110001000000000110101000010000000011001000101000100110000000100000011
01000000000101011000000001001000000010000010011010000001010000100000000001001000010000110000000001100
00000100000100010100000000000100000100000001000000000010000100000000000010010010000000100000010001000
00100000000000000101000000010000011001010000000001000010100000001001000010010100000000000000001011000
00000001001100011100110101000000111000001001000000000000100000000001000000000000010001010010000000000
00001100000000100001000101001000001000000010100110000010000100000000000000000000100000001001000000001
00000001010000110000010000000000101000100110100001100000100000100000000000000000000011000000100000000
10010000000010000000010010000000000011010000100000000101101011000110000000100000000000001000001011110
00011000000000010000010000110100001000011000000000000010000100000000000100000110000000000000000000100
00010000100000000101000000000100000000001010001100001000000000001100000000110100000010000000010101001
00010111000000000000011100001010000011001000001100000000000100000100000000000100000000000000000110000
00000000000000000110000100010000000100100100000000000001000001000001000100000001001100000100101101001
00000000110010100000000000000000100010000010100000100000001010000010000110000000110000010001000000010
10000100000001000000100000000000000001000000010000000000001000110000001100010000000000000000000010100
00100000001000010100101100000000001000010000001001000000001000010000000000000100000000000000000000011
10000001000010010000000000000010000110000000000100000010000000000000000000001000001000000000100001000
00010000010000000010110000010001001000110011001101000100101010000000000000100100000010000010000000100
10100001000010010001000010001000001100000000001000000000000000001101100100000000101000001000100000001
10000001000000100001000011000000001000000001000100100010001000010100000000000000001000100011101000000
01000000010110000010000000110001000010000000001100011010000001000001000000010000100000001000000000010
00000000000000001000000000000001100000000100100000010111100000000000100000100010000000000000000000001
10010011000001000000000000000100001000000000000110000000110000001001100100000000010000000000000001000
00000001000000010010000101000000001000010000100000000000000000000000100101000000001010001010000100010
00000000000101101110010000011000000010001001100111000001101000000000000000000000000000100100000000000
00000010001001100100000000001100000000001000001000000001001000101010000001010000001000000000001000010
10000011000000000000000010100000000000000000100010000000000000100010000000010000001000000000000100000
10011011010000001001011100001001000100100000110001000000010010000000000000000000000000000000110000000
11100000001001000001101011010001000000000000001000000000000100000000000001000000000001000000000000000
10110010011000000000010000101100110010000110000000000000000000001000000000000010000000000000100001000
00001100000000100000001001100000000000000000010000100000010100110110000010000000000100000100000001010
01100001000100000100001010100011010001001000000010000001110000100000010000000000000000000011000010001
00100000000000000010000011000000010000000001000100000100100010000000000000000100000000000010001000001
00000000000000000000000000000000100111000100000000000100000000011001000001100100000000100000001001000
00000010010101000000001000000000001010100000010001001100000000000000000100100000000110110011001101010
00001101000001011000000010100100000000010000010000101000100000000000000000001000000100000000000000100
01000000000001001000000001000000000000000000000100111000000000000000001000000000000100000100000000000
10001000001000000010000010000000000100000000000000000001000100101001100010000000000000001100010000001
00001010001000000000010000000110000000000000100000100001000000000000000100000000000010000000100000001
00000000001001100000000000011001000010000001000010000000101000000000000000001000000100010001001010000
00010000000011000000000000000000100100011000000000000000101100000000000110010000000000100001000000000
00000000001000000000000100000100000001001010000010000000010100000110001000010101100010000000010100100
00000000100110001001000000010000000010000110000010000000010001001001010100000000100000010010000000000
00000000100110000000010101000101001000000001000000000000000001000000000100010000100000111000010110100
00000001000100001001000000000001000001000000000000000011001000000000000001100010000000101000001000001
00000000000100000000000000010000001000000000000000101000000111000000010000100000100000001000000001001
01000001000000000100000000000000100000001000000110000100001101000000000010101000011000000101000001000
00101000010001100101000000000100010000000010000000000000001000000010000000000000000000000011000100001
00000000000000000010000000001000001000000000010100000000001000000001000000010100000000011010010110000
00100010000001010000100000000010100000000100000000011010110010100100100000100000000010010000000000101
00000000000010110000000100000000000000000000000000011000000011000001000000000000010000101001000000000
00010000100000000100000101100010000000100011000100000001001000011000000000000000000001000000000000000
10010000010100000000100000000000010001010000101000000001000001101100010100000000001011100100000101000
00000100001110010000000001000010000000101000000000000010011100010010000001100000000010000100100000010
01000100010110000001000001101000000011100000100000010001000001000010010000000000000000101011000100100
00000010010000000000100000001100010000000001010000100001000000001000100000000000101000001000000000010
10100000000101010000100000010000100000000000000010000101000000000011001000000000100000000100001100000
00000000010000100000000010000100000000000000000001000010000001000000100000000000000000000100000001010
10110001100000100000000000100000001010000001000010000000000000001000100000000000000000100000000110001
01010001110001000000001000000010010000000010000000001000011000000101000000000001001000000000000101001
00000010110100000000000001100010000010000000110001000000001110000000000000000001100100000001000000010
00011010110000010000010000001000000010100000111000001000000000000000000000001100000100100010000011010
00000010100100000010000010000000100000001000000101000001000001000001000000001000000100000000001000011
00010000100000001001000100010000000000000000000000001010000001110000000100000001000000000001010000000
00011100010000000110010000000000000110000000001000000001001000010000001110100110000000100000000101100
10000100000001000001001000011100001000100010000100010100100000000100010100000110000011110000010001100
00000000000000001001000000000011000001000110000001000100000000010100010010000011001010100000000000001
00000000000001000000001000001010001000000001000101000000000010000000101000001000000000000010100000000
00000000001000000000100000001110000001100010000000000000001101001010001010100000000010100001010010000
00000101010100100001100000001000010010001001000100000010000000000001000000000000001000101001000011000
