01001100100011110000000000011000000000000100101000010000000000001000000011100000000000010001000000011
00100001100011001000000000000000100000000000000000100001000010010000000000000000101100000000000001011
00100101010101000001000000010001000010000000000001000000000000011000000001000110000000010100010010000
01011000000000000010000011000001100000000000000000000001000000000000000000010100000100001101000001010
01000000000010000011100000000001100000000000000000010010001000001000000000010010011100000010000001100
00010010000000011000011000000011000000100001001001000000100000000000000000001001000000010000000010000
10000000000100101000000000000000000000000100100010000001000000010001000000101000000000000000001000000
01011000001100000000001100000100000000010000001010000010000010000001001000000010010000100010010000000
10001110000010001000010000000000000000001010000001100000000100000000000011000100100000000000010000100
00000010000001000100010101000001011100010010010100000000000000000011000000010000000000001000010000100
00000000000010000101000011000010000000010000000000000000000001000110010000001000000010010100000001000
00100000000001000000000000100000000100010100100000000000100000000001010000010101000010010000000001010
00100001000000011000110000101000110000000000101000000110100000000001000000000000001000100001000100000
00001001000001010000010000000000000000000100000000010000100000000000000000000000000000100110000000000
00100000000000000000000010000010000000001010000001000000010000100000001000000000001001001000010001010
00000100000000000011000101001010010000100000100000101011000000000100000000000001011000010100000000010
00001010000000001101010010000000000000000000100011000000000010000010000001100011000100000000000000000
00001001000000000000000000000000000000000001001000110001000011010100000011000000000000001000000010010
10000000000001000001000000000001000001000100001000000000000000000000000000101000000000000110001000010
00000100000100000100000000010011000000100000000011000010010100001000000000000010001010001011000101000
00000000000000000010000101001001001000110000000000001001001000001100000000000000010100000000000000001
00011000011001010000100001110000000000000001000000010000001010000000000000000010001100001000000000000
10010010000101000000000000000000000000000000000100000000001001011011001000101000000000100000000000000
00100110000000000000000100000010010000100000000000000000000110000100100000011010000010001101000000000
00000000000000100000100010001000000011010000000000010100000000000011000010000010000010001100010000000
10000110000001000000000011100110000000011001000000001000010000000010000000000000000000100000000000010
00000001000000100101000011000000000000000000010000000000000000100000000000010000010100100000000100000
10000100000011100000000010001100101000100010110001000000000000000010011110000000001000000000000000100
00000010000000000100000001100000010000000000000001100000000100000000011100110000000000100000000001000
10000000100000001000000010000000000100000000000001100000001000100000000000000100001000000000001001000
00000100001001001101000000001000000000010000000001010100110001001001001000000000010000000110000100100
10100100000010100000000000010000010001000000110000110110000000010010100000010010100000000001000000100
01100100000100100100000100000100100010011001000100000000010000010000000100100101010000000010010000000
00001100000010000000000000000010000000001001010001000000100000000000000000001000010000000001000000100
00000100011100100000000000001100000010000010000110000000000010001000010000101100000000001000000011110
00010000101000000000000000000001000000000000010010010010000000000000000101010000001000000001000100000
00100100001101000001000001000000001100100000000100001000010000000000110000100010001000101000000000000
00000000110010000011000001010011001010110001000000000110010000000010000001000100110000010100000000000
10000010000000000001000011000000100010011001001000110110011100010000001001000000001000000000100100010
00010000000100011100011001100000000100001000110000000001000000000000000000001000000000000010000000000
10000000000000000000000000000000100000000000000000000000000000010000010100010000000000000000000000000
00000000000000001100000001000001000000000100000000010001100000101000000001001000001000000000000000000
00000000000000101001100100110000000010000000000000000010000000010001011001001010100001101010000000001
01000101010000000010000100010100000100001000000000010000100000000000000101000001001000000000010010010
00000000000100010000000001100001000000000100000010000011000000001100100000001000000000010001000010001
00001110010010000000000011000011010000010000100000000000000000000000000001000000000001010000001000001
01001000000000000000101000000000100000000000000001000000000000000000000000101000000000001000000010000
10000110100000000100001010000000000000000011100000100001001000000000000001000001000000000110001000000
10000001100001000000111000100000001000001100010000000010010110100000000010000001000000100000110100000
00000000100000000000010000010000100000100000000110001000001010000001001010000010000000001001001000000
00000001010000000000100000000000000000100100100000000000101000000000000000000100000010000000010000000
00100000000000000000101000000101000011000000100000000110100000100000000001010000000001010110000010010
00000010001000000100000000000000011100000000000000000001000011110000000000000110000011000000010010000
00001000010000011001000100000000000000000000000000000000000001000101000000000100001100010000010010001
10000000000000010000101000001100001010000000000001000110010100010011000001000000010010000000000000010
00000010000000000100001000000100101000001000000101100100010100000000000000000000100000000001000001001
00010100001000011010000000111001000000001000000001001100000000000010000000000100000000001010000000000
01000000000000000000000000100000110000000001000100000101001100000000100010010000010000000010100100000
10110010000000000000000000000001000001100010000001000000100000100000000000000001001001010001010000000
00000000100100100000000000001001000000000001010010000100011000100100100100001010010010100000000010101
00000000110000000100000100000000000001000001001000100000000000000000000011000001010000000000000000010
00000100010001110000010000000110100000000000000001100000000000000100000100010000011000001100000000000
00000010000010000000000001010000000010010000100010100000001001000010000000000000011100001000000000001
00000000000000000001000010001000100010001110000010000100100100000000000000001100001000000000000001000
11001010000100000110000001100000010000000000000010011000000000000001010000001000100011101110000100010
00000100100000000000000000001100000000010000000000000001110000000000000000001100001100001000010100100
01100000010010000000000001110011100000010000000010000001000000000001011100001100000000000110000010000
00010011000001010000000000000000100011100000000100000001111100000000011000011101000000000000010000100
01000000000000101001010010000000000001001100001100000100101100100000000100000000100000000000000000010
00101000100100000000100000100000100000100000001000000000000000001000001100001101100000001011000011000
00000000000000100100110000010000000000010010000000000100000000010100000110000000010000001010000100000
00000000001100000000000000000110010000000001000000001000010001000100000011010100000000101000000010000
00010101000000000000001110000000000110000100000000000000010000100010011001000101001001000011000001100
00100100000100000000000100001010110000000011000000000100100011000001100001000010000100010010000010100
10100000100011100000001001000000100001000001001000010000000001010000111010001001001000000101010001000
10000101000010000100000001000010000000000110001010100001110100000100000010000010000000000000000000000
01000000000000010000001000000001100100001100000000001000101101000011000000001000000000010000011011100
00100000000000000000001000000001110100000011100000011000101001000000000100100010000000100000000000001
01010000000000000000000000010000010000000000100000000100000000000101000101101001000101010000010000000
00100000000000000001000010000010001001000000001000000000100000000000010010010111011010000000010000100
00000100000000000100000101000000000000000000000000010000000100000001000001110010000000010010000000000
10110000010000000000000000001011000001011010000000100001100000000000000001000001000000000000101010100
00000000010010000000010000100000010001000010000010000000001100010100101101000001000000010000000000011
11010100000001000000100100000100101000010110000000000010000010110100001001000000111000000000100100000
00000000001001001001110110000000010010000110000100000100000100001100010000000100010001000000111010100
00011110000001001010000101000000000000001000000000000000100000011101101100100000010001000000000001000
01110000011000110000000001010000000000001010000010000000000100000000000001001100001000000010000010000
00010000011000000000010000001000000000101001000000000011010011001000111100000000000000100001000010000
00000000000000000100000000000000000001010000000000000000100010000010010010000000010101100000000000100
00000100000001010000000000000100101000101100000100000000001000000001000000001000100001100010001100000
00000001100000110000000010000001000000010000110000010000000001001000000000000000001000100000100100000
01010000000010011000100011000001000100000001010000010011110011010010001001000000001001000000000010100
00000000000000000000000000000000001000000001000001001000000100010000001000110000100100100000010100010
00000000000000010100010001000000000001000000001100000000000000000000001000000110000000010000000000010
00110000000000100100100001000010100000001000100010110000000110001100000001000000010001000000010000000
01000000010100001000000011000000000000010000000000000000110001010010000011000100001000000001000000100
10000101000000000000000010100100001010000000101000001010001000100000110000010000000100100100100000000
10011001000010010000000000001000000010101011000000000100000000000000010100000100000000000001110000100
00010100000100000100000000000010000000000101000000000011001000000000000100000000001000000000010000110
00000001000000000000001110000000010000010011000000000001001000000000010001000100000000000001000000010
10000100100000000000000010110100000010101000000001100000000010000001101000000101010000001000000000100
