00111110100000001100010000000000000000011000100000000000000000000000000000000000000010010100000001000
10100000100000000100001001000000010100000000110000001001110001000000100000000100000000100000100100010
00010000000100000100001000010000101010000000100000000000000000000100000101000001001000100000100000010
01000001000000000010000001000100000001110100000000000100000000001010000000010100000010000000000000001
00000000000000000000000000000100000000000100010000000001011001010100001000000100010000001000000000101
00001000000001010001100001000100000010000010001010001100000001000000000000010001000000000000000000000
00001010100010000100001110110010011011000000000000000010000010100000100111000000011000010000000000000
00000000101000000000000000000000000000101000000100010000010100010001101010000000100000000000010000000
01010000000000000100011000000000001001000100000010001001001000000010001000000000010000000010000010000
00010001001001000001000000000000110110100010100010000110000100000001010000001100000000000000111000101
10000100000000000000000000010000001001000000010000101100010000000000000000010001010001000101000001000
00000000000000011000000010000011000000000100000000000100001010000000000000001000011000000000001001100
00010010111100000101010001000010000000010101000100000101000100000010000001000011000000000101000000100
01000000000001000000000001010000011100000010000100000001010000101100110001000000010110000000000100100
00100000001000001011000000000010100100001010000000000100010001101000010000000001000000000000001010110
10010100100010101000001110100000001000001001100000011001011000000000000101100101100011000000000000000
10000000000000000000000001000000000011100000001000011000001101100000100000000100000000000000000010000
01000000001000000000000000100000000000000001100010010000100001000011100011001000000010000000010100011
00010001100000000000000000000100100100010101000000000000000000100010010000000000000100000000110011000
00010010000010000000010000000000000110000001000001011010001010000100100000011000001000011000000001100
00101010010000001000101000000000100010001000001000000000000110010110000000001000000100010000000100000
00000000101101010000010000001000000000010000100000010000000000000100001100000000011000000000000001010
01011000000000000000100000000000000000001001011000000001011000001001001010000100000011110010000010000
01000010000000000000000100001010100100000001000000000000100000000000000111000000000000001000011000100
00010010010000000000000000001000010010000010000000010000000000000010010010011000000001100100000000000
00001100010100000000000001000010000010000000000100000000000100000000010000001001000000101001111000000
00000000001101000000010000000100010001100000000000000100111010100000000100001000000000000000000000100
00000101000000000000011010011000000000000010000000001001010011000010000000000000011010001011100110010
01010010000000000000000000000000000000000000000000000000000001000001100000010110100000100000101000000
10100000111000000000100000000000000100000110000000100100000000000000000000000010100001000010000010001
00000000000010001000000101001001001000000101000000010100000001100000000000001000000001000001000000000
00000000000011111100100000000000101001010000010000000000000000000000000000000001100010010100010000100
00011100110000000001000010001000000010100100100100000000110000000001000001000000001000000000000010010
01000000000000011000000000000000011000000000000010000000010000000011010010001000001000100000000000000
00100000010000100000100100000000000000100000100000000000010010000000100110000000100000000100101000000
00001000100010001000011011001000000000000000100000100010000000000000001100010010000000100000000000001
00010010000001100000000010000000100000010000000010001000111001000000110000000000001000010000000000000
00000000000010010001000100000000000110000000000010000000001000010010100101001100110000010100000000000
00100011010000000100010000000100101000001000000000000000000001000000000000010000110100000000000000000
00010000100000001101000010000001001000000000000000101000000000100000100000100001000000000100000000000
00100010000100000000000000001000000000000100100000100001000100000000100000000000000000000000000000001
00000000000100110000000000000000000000010100000010001010000001100000010000001000000000100110000000000
11000100000000000010011000100000000010010001010000110000100000100000100000000011000110000100000000001
10111000010000000100000000000011000000000101110000000001000000000000011001111010010010000000000000000
00000000000000010110000001000000000000001000000100000000000000000000000000100001000000001001000000000
00000001000000000001000000000010000001100010110100010111000001000000000000000100101010000000000000000
11000101001000001001000110011001000000000000000000000000010000000000000010000000100000000000100001111
01100001000100000000000001001000000000110000000101000000000000000000100000100000001000000000010000101
10000100100000100010001000000100000000000001000000000000110000010010100001000101000000101000000100000
00000000010001010010000100100000000000001100010011100000100000000001001000000000000000000000000000011
01010100000001000010000000000001000000000000010000000010001000000000000111000000010000000100000000000
00000000000000100001100000010001000001100100101010001000000000101000000011001000000010100101000000100
00100000010010001000001010010001000110100010001001000000101100100101001000000001001001000000000000000
00000000000010000000000000000000000100000000100000000010100000010000000010000000100001000010000000010
01000000000000000000000001011001100000000100000000100000000101000011000001001000000001001100000000000
00000000000011101000010010000101000001000010000100000110000000110010000000000110000000011000100010000
00001000000000000010000010000001100010000100000000000000001001010000001000010001100000000100000000100
00100000000000010000000100100000000010000000000101010010000000010000000100001000000000000001010001000
01000101000110001100010000000000000000000000000010000000000000000100100100010100001010000000010000000
10001010000100000001000100000000000001100000001010001000010000101001000000100000010000010010000000000
00000000000010010000000000011100000100010000100000000010100010001000000000000000100100011010000000010
00000000000000011011100100000000001000000001000000100000000001000001010000000011000000000000000001010
00000000000000001001000000010010010001010000000100100010001000000000010111001000001000000000001011101
10000000001001010000000000000000100000001100010000000000100000110010000000110010010000000000000010001
10001010100000000000000100000010000000001000010011001010000000000101000000000000000010000100000000000
00000100000001000000000000010000001100000100000000001000000010001000011000010000000010000010100001000
00101000000100000000000000000000000100001000000000110000011010000000000000000101100000000000000010000
00001000000000000001010101010001001000000001011100100100000000000000001000100001000010100000001100000
00000100000000000000000010000011000000000100001000001010010010000000110011000010000000000000010000000
00000001000101000000100000000110000000000000000000000000100000100100010000000000000000000000000001100
10010101000000000000100000000000000000110110001000000100100110000010001010101000011100010000000010000
00010011101000000000110000010010000001000010100000000000101000010010001000000000000000000110000101010
00100000000000000100100100000000000000010000001001000000000001000110010100010000001000000000100011001
01010000011000010000000000010011000001000000010001000000000101000100011011000010001000010100000000010
00000000010000000000000000010100000000000000001001000000001100000001000011011000000011000001010000000
00100100001000100001100000100001111010000000000000100000100010000010000001100000000000000010001000000
00000000000000000000100000000000000000000100001100010010010000000000000000100001000000000101000100000
11001000001101100000010000010100010001110001000000001000000000000000000010000010000000000011000001100
00000000000100001110000000000000000000011100000000000010000000000000100000000000000000100010000000000
00000000010000000000000000100100110010100101100100000100010000000001000000001101101001100010000000000
00000001000100110010010000001000000000001000000000010011100001010000000100000110000000000011000000100
00010001000000001011000001000000001000010000001010001001000100000100001000100000000000101000000000100
00000000000001001000000011000010001000000000001000000010000010000001100001101011000000000000001100010
11001000001000001001000000100100010010110100100000100000010100000110100100010000100000000001001110000
00000100000001010001000000010001000000010000011000000000001101000100010000101000000000001110110000000
00010000000000011000000100000011001000010000000000100000000010000000110000000100000000000011000000001
00110000000010010000000100000001000110000000000011000000000000100000000001000011001001010000000000100
11000000000000010010001101000101000000000001101000100000001001100001000010001111100000000000100000000
00000010000100011000000001000000000000100000000000100010001000000000111000000000000000000100010000000
10100000100000110100000100000000001000001010011000000000010001000000000000010001010100000100000010000
00000000000110000000000011000000100000000000000000010000001010010100000000000010000100010000000010000
10001001000000000001000010000100000100000000010010000000000110000001110010011000001000010000001100101
01000110000000001000101000010000100001100101001100000010110100000000000101000000000000010000000001000
00000000000000010000001001000000000000010000000001000000000010000000000000000010000001110001000000001
00000000000000000001000001010000110100001001001001000000000100001000111001001010000010000010100000100
00001000110100101000101000000000001001001001000010000001000000000100000000000100100001000011010000000
00000000000000000000000100000001010000100000001000001010000001010011000001100001001010000000100000001
00000000001000011000000000100000000101001000000001001000000001000000100000001100001000010001000101000
00000000000000000000000000100000010000000010010000011000000011110100000100000000100000000000000001010
00000000100100010000110000100000100001001000000100000000000000000000000101101000000000000000010000000
00011000000000000000000000000000101001000000000110101100000000000011000010000010000000001000010000000
