00000100001000000010001000000010000001000010000000000010000010000000100000000010010000000010000100100
01101100001000000000000000000100100000000000000001100000110010000000000000000000000010000100000100000
00000100010000000100000100100100011100000000000000101010000100000000001010000001001000000100000000101
10000000001100001000100010000000011001000000000010000110000001000000000101000101001000010010000010000
00000001000100000000000010000100000000100000000010001100000110000000010000000000000110000000010000000
00000000011010001000100010000000000110010000000001010000000011000011000000100010000011000011010000000
10001000001000001000000001100000000110000010000000010000001000000000100100000001100010000000000010001
00000000101000001000101000100000000001000000000001000000001110001000001000000100000100000000110000010
00001100000000000100000010001010000000000000000000000000100001001000000000000000000001000010100000000
01000010000101000000000001001000010000000000000000010000100000000000100000000000110011000101100000010
10001000000001010011010000100000000000000000100000000001001100000000000000000000000000000000010010010
00011001000000000000001000000010111000110101100001000000000100000011100010000100000011000000110010000
00101000000000100000010000000000100000000000010001000000000000000000000000000001000000100000100000000
11101000000001000001111000000001001100010000000010000000000010000000101001001000001000100000000000000
00000001000100000000000101001000010000001110000001000010000000110000100000000000010000100110010000000
00111011001010001000010000000000001000000000000000000000010100100000000000000010100000000000100000000
00010000000000010100000010000001000010000100000100011001000000000000001000000110001000000010000000000
00000000000000101000000000001000000010001010000000001100000000000100000000000010001000000000000000000
01001000000000010000000000100000000010100001000000000100010000000100010100001000000000000000000001010
11000001000010000000000001000000100100000000000000000110100001110010000000000000011010000000100000100
00001000010001001000001001110000110001100000000010000110000001110010000000100001000000000011000000010
00100100010011000000000000000000000100000000000001000010000000010000100000100010000010000001000001110
00000001000010011000000000000101000000000101010000000100000000000000001110010000110000000001100100100
10001000000010000000001000001000000000000110100000000000100000100011000000000000001001000001000000000
01000000001000100000000001100000000100000000010010000000101001000000010000000011000000001001000001100
00010000011000000000000110000001010100000100011000000010000011000111001000110100000000011000110000000
00110000000000000001000000000001010001000100000011000000000100000000010000000000001000001010000100011
00100100000100000000000001000001000000000000000100010000000000000000000000001010001000000010000000000
00000000010001000000100100100110000011101011000000110000000000000000000001000110110000011000010010000
00000010000100000101000000100000000000010000010110000111001101000100000110000010000100100000001000000
00100000000000100001001110000010010000000010100000000001000000000000010000101000000000000100010010001
00000000000000000000000000000000000000000000000000000000000100000000000010010100000010000000100000011
10001001001000001001000000000000100100000100000100000000000010000000001000001000100100010000000010100
10000010000100000010000000000010000000000001000000000000000000000011000000000110000001001000101000001
01100001001000000000000010000000000000000000000110000001000100000001001111100000010000010000000000110
00000000001100000000001000000011000000100001010100000100000100000000000001100000000000100100000000010
00100001100001010000100000000100000000001001000100000000001010000001000100000000000001000000010011000
00010100000001000000000010000000000010000000001000000000000011001100001000000000010000000000000000100
00100000000000000000000000010000000100000000000001100000001001001001000000000010110001100010001000000
00000001001000000000001100000000001000100000010100000000000000000100010000000000000000001001010000000
01000000101000001000000000010001001000100100000011001001000000001100000000000110000000000000011000000
01010010001010000000000010001000100001100010001000000100000000000010000000000000000000010000000000000
00000001001001000000001000000000000000000001110001000100000000101000000010001010000001000000010000000
10001000000101000000000000000000000000001000000001000110000000000000000000010100001000010000000001000
01000011000110000000110000100010101001011010000000001000000010010000001000000000000000000000101010001
10010001110000000010010100100001000001011000010000000000000000010100000000000000000000010000001000010
10100010000000000000000110000000110000000000000000010000100100000000100000000010011000010000010010000
00000000000010000011000000100010010000110000000001100110010000000000000000000001000000010010100010000
01000000000010001100000001010000010000100100000001000100000010000000000100100000010000000000000000000
00000101000000100001000101101000101000101001000000000000100000000010100100010001000010000100000000100
00100101000010010000010010010000000010100000000010000010101000000100010001000010001110000001000000010
00001000001100001000010000000000000010000000000011000000000000000010000010000000010000000000100000000
00000010000010100000000000010100001001110000000000001000000000100011000010010000000000000000100001010
00000000000000101100010010000000000010000010000110000010010000011000101000100000000000100000000001000
00000000000010000000000010000001000001000000001100000000010100000000000000010001100100000100000000100
00000000000010110000000010000000000001001100100000100000110000100000101000001000000000001100010000010
01000001101101000001010010000010000001100100010000010000001110100000000000101000100010100000000000010
00010000000110000000100100000001000000000000100000000000001010000100000100100000010000010000000010011
00000000011000101100000000000000100000000000100011000001000000000100001101100000011000001000000000001
00100001000001000000000010000000001001001000000101000001101000000101000000000011001000001001000011001
00000101100100001000000100000101000000000000000000000000000000000001001000000010000010000101000010001
00000010000000000000000000000000010000000010000000001000101010000000100000000010000000010000110000001
00000000000100000000000000100000000010000101010101000000001000000000110000100000100000000000000000010
00000010000110000000010001100010010010000001000000000000000011000001000100001011000011100000000000000
00000000000101000000000000000101101001010101100000000000111100000000111000100000001000000101101000000
00111000011000000000000010010000000000100000000000000000000001000000000000001000000010000000000000000
10000000000000100000000000000000100101001000000000001101000000000001001000000101000101010010001010000
00001000001000000000000100110100110000000110000000000000000000000010100001100011000000100000001000000
00000000001000000000000010000001001100000000000000000000000000000000000100010000000100000000000001000
10000000000100001000100001100000001000001100001000000000000000110100101001001000110000000100001000010
00000011100100000000100000101000000000100000100001000101000000100000000001100001010010000011010000000
01010000011000000000010010010000010000011000000101000000000000000000000000101000000000010000010000100
10010000001000000100001100000011000010011000010000010000010000001000001000000000000000000001000010010
00001110000000000010000101000001100001100010000010000010000010001100100010000001000000000000000000100
00100000000000111000000000000000000000000000100011100000000000000010110000000000100000010000000000001
10000010110000000000001000000000100000001100001000000000001110000010000000000000010000000010001010100
00000001001000000000000100000000000000000001100000001011000000000101000001000000001000100011000000000
10010000000011101001000010000000000100000001000000100110000000000000000000000000100001001011011000010
00000000000000000000000000000010010000000010011001000001000000001000111000000100000000100000000001010
00000000010000001100000000001000100010000001000010001000000110000000000000000100000010000010010000000
00000000000000000000000010000010000000000000110000000100010000000000011000000100010001011000000001111
00000001000000100001100000001010001000001000100000000000000000000000000001000001000000010000000001010
00000000000100000000101000000000000000101000000000000000000000000010000000001000000110000000100010010
10001000000011000000000000000000000000000000010000010000000110001000000010001100011110010000000001000
00010100000100000101000001010100001000000000000001100100000000000001000000000000001000110100010000010
00000000001000000100000110100011000010001100000001101000101101001000001100100000001000000001001000000
01011000001000000000110000000000100100000100000001000000000101100001000000000010100000000000100000001
00001000000000000000000001000000100000000000000010000000000100000000011000000010000000000000000100010
00000000000001001111000010000010000000010010000010000110001001000000000000000000000010011000011100000
00000000001010101010001000000011000000010100101000100000010000000001010010000100000010100000000000000
00000000001000011110100001001000100000000110000001000001101000101000000000010001000000000011000000000
10000100000001000001000000100000010000000010001000000100000000000000000100000101010000100000000110000
00000100100000000000001010001000000000000001010000001110010000000000000000000100111010000000000000000
01100100000010000000010000101010011100000001000000000100101000000000000000000111000000000000010000001
00000010011000100010000100001000000010000000000000000001100100000000000100100000000000110000000000000
00000010001001001000100000000010110100000000000000001110000000010010100110110001010110001000000001010
00100101000010100000010000010100001100100000000000010000000010011000000001000000000001100000010000001
00000000000100000100000100000101000000010000100000000000000100011000000000000000000100010001001110001
00001001101000010001100011001010001000000010000110000001010100010000000000000001000100001100000000001
00010110001000010010101000000000110001000001000000000000000011100010000000000010000000000000001000100
00010110000111000110000010000001001010100000010000000010010000000000000100001000000000110000000100000
