00100110000001001100000000001000000000000000100000100110000000000010001100000000000010000000000001000
00010011100000001000110000000001000100011100110000000001001001000000011000000000000000000001000100000
01000000100000100000011001000000000000010000000000001000000000100000000000000101000100000011001011000
01000000100110100000011100000010010000010000000010000000010000000000000000000100000000001001010010000
00000000110000001000000100010100001110010100000011000000010000010000000000000000010100000100000000011
00000000000000000000000100000000000100000000000000000000000010000001000000000100001000000000000001000
00000000000010000000000000000000001010000000001000100000100100101000000000001000000001011000001000101
00000000100000001000000000000001000110000001010100000000000000000100000000001100000100000000000000000
00100100001000000000000010000000010010010000000000100001100001000100001000100010000000000000000001000
00000000000000000100000000000000000100010000010001000000000100001101010000000000000000000000000000010
00000000000000010011010100010000101000000000100110000011000101001000110100011101000000000000001001001
00000000000000000001000000001000100001000001000000100001000100001100010000000000000000001100000000011
10001000001001000001010000001000000000100010001001100000100000000000000000000101000110001000000000000
11001100000000000000001000111000000000000010000000000000000000000100001001000001000000100000001000000
00000001010001010000000001010100000000001000000000001000100000101001000100000100010010000000000001000
00010000011000010000101110100000010000000000110000000000000000000000000000001000000000110000000000000
00000000100000000001000100000000000010000000000000000000100101000010100000000000000100010000010000000
00001000010100000001110000000100000100100001000110000000000010000001110000000001001001100111111000000
00000100000000000000000001100001000000000000000100001000001000001011010001000100000000000000100100000
01000100000000101001001001000000010011000011000000000000000100001000000001000000000000000001100000000
10000100011011000000010101000010000010000000100000000001001111001101010000010011000001010000000000000
11000101100000001000000000000011001010100001000000000000000010000000000001001000001000100000001110001
01001101001011100000001010000110000110000100000000001000111100100001000000100000010000000001000010000
10000001000000100000000000000001010001010010000000000000000010000000000010000100000110000000100000100
00000001001000000001000100000000100000000001000100101011000100000000000000000000010001000010000011000
00100001000000100000000000000000010010011001000010101000001000010000000000000000000000001000000000000
00000000001000000000000000000100000010101101000010001111101001000000001011100011000000001100011000100
00000000001000000001000000000001000001000010010100000000001000000000000100000000000000000100001100000
00000000001000000100011100000101101000000000001001000000010000000010000000000000000000000000001000000
00010001000101001010010000000011000011010001001001101000000100000000011010000001000000001000000000001
10000000000000000000000100100000000100001000001000001001000000000100000000000010010000000010010010100
00000000110111010000000011010000000000000000000000000000000011001000000000010001000000000000010000100
00000100000000011000000101010000000000110000000010000000000000001100010010010000000000010001000000000
00000100000010000000110110110000000000000000001100000100010000000000001000011001010010000100000000010
00000000000111101000000000000010010100000000000001000000110000010001011000000010000110000111001001000
11001000001000000110000000000001000100000011100000001000000010000001000100001000000000000100000000100
10001010000001001000000000000001000001000000110001000100000000000010101000001000000101000000000000000
01100000000100000001000000000011000100111000100000010000000000010000000010010010111000010100000000000
00000001000000000000110000000001001000000000000100101000101000100010100000000000000000000000010100000
00000000000100000000010010100100001000000000110000000001000000000010001001001000000000000000100000001
10000000000000000000101001000101100010000100110110001000001000110010000010000000000000000100100001000
01100000000000000001001000100010101000000010000110000101001000010010100000000101000000010010000000010
11101011001000000010100000100000010100000000000000100011000000000000000000000100100000000000001110000
00000000100000000110000000100000110000000000011001000000000001000000000000000000010010101010000000000
01000001000111000100000000100000000000100100101000100000000000000000000000000010010000000000000000000
00100001001001000000001010000000100000010000111000000000000100000010010000000000100000100000000001000
00000100000000000100001000000000010011000000000100000000100000000001000000101000000100000000000011000
00100000011000001011100000100000000001000100001100000000000101010000010010000010000100000000011000111
00001000000000001010100000001100000000000111000000010000100000000000000000000000000010000000001000000
00100000100000000100000001000000100100011010001010000010100000010000100000000101000000000100011000000
00000001100010000000000100010001011000001000000010000000001000000000100110000001000000000011000001000
01100100001000100100000000000100001000001000000000001001000000000000000101100000000000100111000011001
01010000100000001000000100000001000000101000000000000100001000011011010000101100100001000000100000001
00000000000000000000000010100000010100000001000000100101001000100000000010100000000000000010010000010
00000100001000000000100000000000010000000010000011001000000000001000011100000010011000010110000010100
00000000000000000000000000100000000010000000101000000000001000000000101000000000100000010000000000100
01000000100000010010100000000000001100000100000010000001001011010001100001000011100001100100100000111
00011000000010100000000010000000000100000000010000100000001100001000000000100000000100011100110001000
00000000000000000110000000001010010000000000000001100001000100100000011000000100000010000010001110010
00010100010010001000000000010001100101100001000000000100000001000010000000000000100001000000000100011
10010100000110010100000010010100000100000000001000000100000000000101000000000000010000100101010000000
00000000000000100000010100010000001000010000000000000000001000000010001101100100001000000011001000000
10000000000000000000100100000000000110100100000000100110100010100000000100011000000000000000100000000
00010101010000010000010000010000001000000000000101001000000000000000110000010101000010000000001101000
00000001101001010001001000000011000000001010100000000100001000110010000000100010000000010001000000001
10000001010001000000000011000000000000000000000000000000110011000000000000100001000011010001000000000
10000010000000100010000000000010100100000100110000000000000000000010010100000010000000000000011000000
00000000000000000101000001010010000000000100000000100000000000100110000000000000001010100000010100110
10111100000000010110010000000100010010010001000000000001000101001000010000010001000101000000000000001
01100000000000000000000001000100000000100000000010000010000000000010010000000001100000000100000100001
01010100011010000000000000000000000000100000000010100010000100011000000011011000010100010000000110100
00001000000000000000000000000011001000100000001001000000000000000001000000000000000000000000001000000
00001000001000010000000000000000100001010000000010000000000001010010000000000011000000000000100000000
00000110110101010010000000001001000101001000000100100000010001000000010010000000000010000000110000000
00000100100000000000000001100000000000000000010000010010000010000000000000000010000000000000000000000
10001000000100001000000000010001000100000000001010000100001100001100100100000010000000001001100000100
10001011000000000100000000000100000000100011000000001100000000001100000001000000000100000000001011000
00000010100011101010000000000100000010000101000100001011000000010001100000000000000000000000000000010
10000010000000000010001010010001001000000000000001000100001000000000100100000000000000000000100001000
00000000100110010000000000000010000010000000110100000010010001101001101100001000000010100001100101000
10000000000001000011010000000100111000000101000000100100000001001100000100000100000100000000000010000
00010101000000000000000000000000000100000101000000010000010000100110000001000110110100001011000000010
00010000000010100000100000001110000000000000000000001000010000000110000000101000000010000001100000000
10000000001000100000011000000000000010000000000000000001001000100000000000010000000100100001001100000
01000110000001000010000001110001100010100001010000000000000001000000000000010000000100000101000000001
10001010000100100100100011100001000100000110000000000000000000000001000000001001000000000000001000000
00000000000100010000000101000000100000000010000100010100010010001110000000000001000000100000000000011
01000010011000000000000000000000000000000000000000000010001010000000000001100000100010100100100000000
00000010000000010100100111000101001010000000000000010000001001000000001000100001000010001000000010010
00000010100000000000100101001000001011100010010000100000001010000001000000010110000000000100000000000
00000000100000000001001100001010010000000000100010100101000000000011000000111000000101100100001000101
01001000000000000000000001000101001000110000000001000000110100000000001000100001011100000000001000001
00000100000100001000000000010001000100010000000000100000010001000100000101000001001100000100000000110
00001000001000010100000000000000001001000000000100000000011000111000000100010000000000001100000000100
00000010000100000000100010000000000001000000000000001010001000000100001000000000000000101001001010000
00001000000000010000000000000000000010000100000000000000010100001000010101000000000000000110000000000
10000010000000000010000000000000011000100000000000000001000010000011010000000000100000001000000001000
00100001000010010010000100000000000100001000000000000101000110000100100100000000010000000000000010000
00011000000100000000010010010000000100010000000001000000001101100100011000000001000001100001000000101
00000000000000000000101000000000001000010000000000010000000010000010000000000000110000001000011110000
00011000000000100101100000001010000100000000000000000000000000000011001100101000010100000110000000000
