01110000000000010000000001000000100100001000000010000000000110000000000101000000000000000010010001000
00000100000011000010000010000100000000000100000101000100010000000010000000100000000000000100000000000
10000000000011001010100100000000001000000000110000001000000010000010010010000000100001000010011000000
00100010100000100100010000010000000011110100001100000000100100010000000001100000000100000000001000001
00010000000000010010010100101000000110000000100001000000100000001000000001101110000000000000001000110
00100100000001010000010100000000010100100000010001000000000000100101011000000100100000000000000001000
10000000000000000000000010011000010100100000000000001110000000001000000000001000000000000001001000000
00000010100000010001000000000010010100000000000100000000100101010000000000000000000000010000000000100
00100000010010000000000000000000001010000011000000000001101101000000110000100000001000010001000100111
00000001100000000000010010010000000100000000000101100000000100111001010010000000000000101000000000100
01000010010000000000100000100011000001100001000000001000000000010001000100001100001000000000001000000
10000000010000000000100001001001000100110000000010011000100000000100000010000000000001000000000000000
00000000010010010001000000000011000101100100010011000000000010000110000010010000001000100000100010100
00000010100000000011000000101000010001000000010000100000010000001111000000100001000011001000000000000
00000010001000000010000100000000110000001000001100000000000000100010010111010000000000001100000100001
00000000000101010000010000000100100010000010000000010000001000010000000010000000100110000000000000100
00011110001110000000000010000000000100000000000000000001000010001001000000000110000000000100000000010
01000000100000001010010000000000110001000010000010100000000010000100000000000010000000000001000000001
00000000000000000100010001000001010000000000000000000000010001000000000000010000000000010000000000000
10100000100100000010000000001000001100100000001010110101110000100000101000000000000000100000001001101
00000001000000001000000101000000000011010000000010000000000000000000001100011000000000000000000000000
00100000010100010001000000010000010100000000000010010011000000000000000000010000000000110000000000001
00000000000000000000001000011000000010011000001000000001100000000101000000100001100100000100000000100
00010000010000100000000000000000000010100000011000110000000010100010001000001000000000000000000000000
00000100000000010000000100001010000000000000100010000100101000001000000100000001000000000000100001000
00000010000001010000001000010000010001100000101000001000000000000010000001100001000000000000000100000
00001011000001010000110100000110010010000000101100100000000110100000000000000011010000100000000000000
11000100000000010010100000000100000000000100100000101011000000001010000000001010000010110000001110000
00000000000001000000000100010000000000010000000000010010000110000100100010000000000010000000000001000
01000000010000000101000101000100000000100000000000000000010000001000000000000100000001100000100000000
00001000000011000100100000000000001100001010010011010001000100011110100000000000010000010000000100010
00001000000110100110000001010000000000100111000000010000001000000000000001000001000000100000000110010
01000000111000001000010101000000000000000010000000010000100000000000000001010000010100001000010100000
10000111100000011110000000000000010000101000000001000010000001000000010001001100000010000000000000000
00001010001000001010100110000001000000000100000010001100000000000110000100000001100011000000000110000
10011000100011000000000000000000110000100101000000000000000000001000010000100000000010000001010011100
00011000000010000000000000000000001010000100100110000100010000001000000110000000000000100000000000000
00000110010000000010001000110000001000000010000000000000000101000010100101010001001010000000000010000
00000000000000000000000000001000000000110000000000000000010001000100000000100000000010000001100011100
00001001000100001100011000010000100000110000000000000000101000000000000010000000001010000000000001100
00000010110010001000010100001000000011001000000100000100010000010010000010000110001001010000101110010
00001000000101001001001000000010000000010100111000101000101000110000000000001100010010001000010100000
00001000010000001000000001000000001000100000000000000010100000000000101100001000100000000000000000100
00011001110000000000001000000000000000110100000100000000100000000000000000000000000000001100100001000
00000100100000000001000001100010000000101010101000001001000010000000000000010000111000010000000000000
00000000000100000000000000001000000010010010000000000010000001010000000000000000000000101100000000000
00000000001000000101000000011000001000000000000011010000000001000000000100001000000100000110000000000
00010000111001000100000000000000000001100010000000000000000000000010000010000000101000000000000000000
00100101000100001010010001000000101001000000000000010001001000000010010000110001000011100110010001001
00000000001010010000000000010000000000001000000010001100001000000000000000010000000001000001000000000
00110000010001000000001000010000000010000000100111000010010010000100100000000000000100101011000000010
00000010000000100000001000000100011000100100000010100100000001100010000000001000100100000000000100000
00000110000000000000000011000000000010000000001100010010010001011010000000000000000000001000000000010
00000000000000010100100001000110010000001000000000001000010100000000000010001110000000001000000010000
01000111000000000001001000100100000000000010010000111000000000000000010000110100000010000111000010000
00001001000000000100100000000000001001000000000001001000000000000000100000000010000000000000011000000
00000000010000100000000010100000100000111000011000000010010000000000000000100000000000101110001000000
00001000100011000010000000101000010100000100000100010100000110000100100000000100001110000010000000010
10000001100000001001010111000011000100000110001100000000100000000000000000000000000001010000000010000
00100000001000000000000111000010100000000001000000110100000010000000000000000011000000001100000001000
01010100100010100011000001000000000000100000010010010000010010000000100001000000000000000000000010000
00010000001001000000100101001000001100100011000001100000000100000000100110000000001100000000100000000
00000001000000110001000000000001100001010010000100001000000000000000001000000001000000000000001010000
00010100001000100010001000000001000000000110000000010100000011110001000000010010000000000010100000000
00000000000000010000100000110001000000001000000100000000001000000000000000000000000000010000100100010
10010000100001001000110000100000000010000000000000000000000010000000100010000001000000100000010000100
00000000000000000000000001000000001000010010000010001000000000000010100100010000000100010010000100110
10000000000000010010000001000001000000000000010001001000000001000001000001000000110001000000000101000
00000000000001000000000001100011010000000010000000010001000000000000001000000000010000101000100101000
00000000010000000000110010010000010001010000010000001000000000000000100010000110010010001000000000000
00010000000000000001001010000100000110001000000000000000101001000110000100010100000000000001000110000
00000001000000101000000100000100000000010000100011100000001011000000000100011000111000100000000011100
00000000000000000000110110001101100001000001000110000100000000000100000000110100100000000001011010000
01010010010010100010010000000100000100000000011000000000000001000000000100100010001010100000000000001
00000011000100010010010000000000010010000001000100000001000000000010000100100010000010001000000000000
01010110000000010000010000000000000001000001000010001010010010000010010000000100000000000001001101100
00001000000000010001000110000100001000100100100101000000000100100001001001000001000001001000001100000
00001001010000111000000111011000000010010000000100000001011000000000001010100100000010000100000000000
00101011000100000000000100000010110100000010011010000001000001100000001000000001000110000101000000100
00000000010000010000001001100100101100000000000000000001000001001000011000000000000100001100000000001
10000001101000001000000000000000000100100000100000001101011000001001010000000010000010000000000000000
00000010000000000010010000111101000100001001001001000000000000000000000000000000000000000000100100000
00000011000000100110100000010100000000000000000000000000010000111000000100001000001000000011000000000
00010001010000001100000001010100100000010000000001000000000101000000000000100000101000010000000010000
01100000010000000000100000001000000010001000101100000000000001001100001100000000000011000001100000000
01000001000001110010000010000101000010000001011010000001001100010111010000000100000011000000000000000
01101110100100000000000000001001010000010000000000000111001000000001010001000100001101111000000000000
00000000000000000010010000101000000000001000100000100101000100100010000000000000010000000011001000101
00100100101000010000000011000000000000000100000000001100000101101010010010001010000001000000100100000
01000000000011000010110011000000100000100000000000000100010000001000001000010000000000100100100000101
00001000000000000000000110001100001000000001010001000000000010001110000000000100000000000001000011000
10001000000001100000000000000000001000000000000000000000010000000000000000000001001001000010100000001
10000010101001000000000000000000000000000010000101010001100001100000000100000110011010100001000000010
00000001000110100000000000010000000100000010000100100010000110001001011100000010000100000100000001000
00100000000000000100100101000000000101000000011000000000100100000000000001001000001010010010000000000
00111100000000010100100000000000000010000001000100001000100000000000001000010000000100010001010000000
01000000001000000000100000010001010100001000100010010001000000010010001000001000000010000000100100010
00000010101010011000000010101101110000001100000000000000000000000000001000000000000000100110000000010
00001000100000000001000101000000001000001000000000000000000010000000000000000000000000000000000010000
01000001000010010100000000000000000000000100000000000000000100000100100000000000000000110000000001000
00101000010000000001000001011000000000100001000000100000000001000000000010000000000010001001110100100
