00000101111000100001000000000000000000010000000001000011000000000001011000000010000001000010100101000
00010010110010000001000010001100000100000000101101000101001000000000010000000001011001010001000000001
00010010000001100001000001000000100001110010001110011000100000000011100110000010000000001000001000000
00000000000000100000011000010000010010001000100010000000000001100000000000010111001000000100001100001
00000101000101000101110000010010000000001100100000010000000010001000000000001001000100000001110000000
00011000000000000000000010000000000000000100000000001100000000000101001000000010000000000001100011001
00010100000001000000010000000100100000000000000010000001101000010000000010110000010000010001000100000
00001000010001101000000000010001000000000010000001001000010001000000000100000000001000000000000010010
01100001000100000000001000100000001001001001000100001000000100010101000000000000100010100001100000000
00100010010000000010100001000010000100100000010100000000001000011100000000010000000100001000001010000
00100100000000000000000010100100010000000010000010000100000000100000100000010000000100000010000000000
01000001000000000100000101100011000001000000000000001000100000010100000001000000100011011000000001000
00000010010000000100001001000010001010100101000100000001100000000000000011010000000011100101000000000
00010110000000100000011010000000010000000000000100000010000000010100000010000001010001100110001101000
00000101010001000100000000100000000100000111000101011000100000100000100010100010000000000001000100000
00000000010000000000001011100010000000000001100001000010010000100000000000001011011100000000000000100
10000000000001000010000000100000000000000000010100100000000000001000000000000101000100000010000000100
10000101000011111010000000000000000000100000000000010001001010000000000000000000000000100010000000010
01011100100100000000001000010000000100000100010000010000000000000000000010000000000000001100000001000
01000000001100000001000000000000010000101000011001000000000100000001000001000111010010000000000000000
00000000000000000000000000010000011000000100100001000000000100010000000010010010000100100011000011000
10110000001001000100000000100000000100000000100000000010000000000000000001010000000010000001101000000
10000100100100000000000000000000001000000000010001001000100000100000001100010000000011000000000101001
10011010000010100001000001000000000000000010011000010000000000000000000100100010100010000000000001010
00000000010001100011000000000000000110010011000000000000001011000000000001000010010000100000010000000
00001001100000000000000100000000000000000001000000010000000010000100101010000100000100000001010101001
00100000000000000100000110000010000000000000000000000101011000000000000000000000100000100100001000100
10100000110010001000010001000000110000010100010000001000000000000100100000000011000000010000110100001
11000100000001010010000000000101101000010001000100100101000000010100000001001000000001000100000000010
00110000010100000000000100000000000000100010111001010011000100000000000101000100000000010000000000001
00100000000010000010000000000000000000100000100000010110000100110100000100101010000000010001001000001
00000100000000000001000011000001000010001000101010001000101000001000000001110000010000000000100100000
00010100000000000101000000000000100010000000000000000100000000000001000101000011000000010000000000010
00110000010010000000000100000010000100000100000101001000001010000100000000000000100010000000000010000
00010110000100001000000101010101000000000000000000111001000000000100100000000000100000000011000000101
00011110001011000000001100000001000111000000001000100010000100000000000100101000010011101010000000000
00010110010000000000000000100000010100000000100001010010000000000000000010000000000000001000001000000
00001000000010100000000001001001010011101100000000010011000100000000000000000101000110000000010000001
00001010100000011000000110000000000100010000010000000000001000000000000000000000001000000000000000000
00010010000100000100000000101000000000000000000010010000010001000000000100010100001000000000010000001
00110010000000100010100000001001010000000000010001001000100000001000101011110000100000000100110001000
00010000000000000000000010000100000000000000011010010001010101000000000000001101000001001010100001000
00000000110101001000001000010100011100000001000110110100100000000001000010000010000011000000100001010
00000001110000000001000000000000001100000100010010000000001000100010000000001000000000000000100000100
00000000000000100000010001000000001010000100000000011101001010000000001000000000000001100000000000000
00000000100000001010000000100001111011001100000000000010000010000100000000000010000000000010100000100
00011100000000000000000010000001000000000011000001001000000000010000000001011010011101000000000000010
00001100010000001000000000000001100101000100010010000000000000000000101000101100010000000000010000000
00010000000100000101001011100000000101000100000000000011010000000000110000000000100001010000000000001
01000100000000100010000000011011010100010000010000000000000000100000000010000000010001000010001001000
01000000100010000000010001000000000000000010000010000000000000011001000100000000000000000000100000100
11001000100000000000100010000000010000100110101000000000000011000001000110101100000000010000000000000
00100000000000000000000000000001000000000011000010000000111010000010000111000000000000000000001000000
10010000100000001000001000001000001010100001001010000000010001100100001000000101000100000000100000000
00000000000000000000000000011001000010000000000000100001100000110000100000010000000001000000010000010
00000000000000000000101100001000000000010000000110000100000000100100001000000000000000010000001001100
00000000001001010000000000000000000000000001100010100000001100001001000000000010100000000000110000000
01000000100001110001000001001000001000001000001000000001011100000010001011100000001000100000010001010
00000000000000000010000001000000000000000010000000000110000110101100111000100001001011000010000010010
00000010001000000101100000110001010011000000000000000000001010000011101010000000000000000000100000000
01010000100100000000000000100000000000101000110010000000000000000000001001100000000000000100000000010
01000000110110000010000000000000000100000000100000000110011000000000100100000001000000010000000000010
00000011000000110001000000010110000000001000000010101000000000010001000001010010000000100001000100000
10101111000011000100100100000001001101000000100000000001010110010000001111001000001100000001000100001
00001010100010000100100000000000000010000000000000001000000000000100000001001000001000000100010001010
00010000000001100010000001000000000000100000000000000000000000001101010000000001000000000100100010001
00000000000000010001001000000010100010000000000100000100000011000100000000010001100110000001100010100
00000000000000000011000001101000000001000010001000001100001001010100000011000001000000010001000000100
01000100000100011000100010000000100000011010100000100000010110010110000110000000100000000100100001011
00000000000000100010000000000110100000010000010000000011000000000100100000100000100001010000000100000
00000000000100000000100000011000000000001101000000001000001000000010001000000010000000000010010000000
10000000000010010000000100100010000000000000010000000001000000000110001001110000101000010000001000001
01010001011000010010100000010100010000001001000100100001000000000000000000000001000000001000010000001
00000010000000010000000010100000001000011000000000100000000110000001001000000100101100000010111000010
00010000011000001000000100000100000001001000000000000110001010000000000000001000000001000000001100000
00001001011010100000110001000100000000000000000110000010101010000101000000000011000000000010100000100
01000000000000000100001000000010000010000000000000000100000110001001100000000000000000010101000010100
00000000010100000000001000000000000100001010010001000001010000100000010000000000100000011000001010000
10001000000000100000001010000000000100000000000100000010001000100010100111000000001000000000101100100
10011000000000010001001000100010000000000010001000000110000000000100100011000000011110010100100000110
10000000000001000001000000100001000000000001000010110010001000100000101010010100101100000001001101010
00100000000000000100010000001000000100000000000000100010000000000010001000000100000000000011000000011
00000100000000100000000000000001000000010100000100000101000000011100010000100110000010000010000000000
00001000001010101001001000001001000000100000000000000000100000000000110100000001100000000100100100000
00000000000000101100010100000000000001000000000000011001101000000100010100100000000001000000000000100
00000100000000101110100000100000010101100100000001000010010000000000000001001000000000110001000100000
00000000001110000000101000000000001001000010000000000000010000000000000000010001100010000000000000100
01000000000000010100000000111000000000000110010010000100000000001000001110000010000000001000001000000
00100000010001001000000000000010010000010000010000000001000100000001000011000000010000000000100010000
00000001000001110110000000000000100001000100000000000001000010001000000000010000100000000110100100000
00000000000000010000001000000000001000010110000001000010000000100010000000001000000000001001000000010
00100001000010000000000001111100000000010000000001000000000010000010000000001000001110001000100000000
00000000000000000000001000000000010010100000000000110110100001000000000000000100010001100100100000000
00000000000100001000000000000001000000000000010000100000010001001000000001000000000000010000000000000
00000001000001000010001000000000000000000000000001100100010100010001000000000000010000001100001000010
00001000000100100000100001011000000001110011000000100000000000001000001001000000000000000011011000001
00000000100010000000001001000000000011010101100000100000000010000000000111000010000001010000010000010
00000000010100000100010000000101001100000000000000000000000100010000000000000000100100100100010000000
00011000001000000001001000000010000100000100000010000000000000001001000000000000000000000000010010000
00010000100000100010000010010000000000000100000000101100000010001111000000001010001000000100000000000
00001100000010000000100000000000000001000000000100100000000100000000001000100000000001000001000000000
