01000100000000000000000110001000000000000001100001000000000011000001001100000100100001110010001001000
00001100000010110000011001000100000000000000000001000000010100010000000001100000100101010000000000000
00000000000000100101001010100000001010000001000000100000000001010000101110100001000000000000000110000
00000000001000100000001000000010000100000100001111001000001000000001100010000000000100000101000000010
10000001000000001000001000101100000000000000001000010010000000000010000010000001001000010011010001001
00001000010000011010001000101001000000100100011000000000000011000000011011000000000000000000000100001
00010000000100100001000000000000000000011100000101000000000100000000000000001000100110001000110110000
00000000000101001000010101000100000000000100000000000010011010010000000000000000000000000000000010000
10000000001110000010001000000100000010000001000000000000100100100000001000010110000001001000000010000
01100000000000000010010100101000000100001000100000000001010000000000001001000100000000011000000000001
00000110000000000000000100000000000000000100000000010000100000001000010010011101100000000010000001100
00000010000100010000010000100100000110001101011000000010000000000100000000000000000000000000000011000
00000000100001000010001000000000000000000000011000101000001000001001100000000100111010000010000101000
01000000010001100011100001000000000000000011000000110001000001000000100000000000000000100000001100000
01100000001100000010000000000000000010000110001001100000000000001001001000001000000000000111000001100
00001000010001000111000011010000000000000010000000000000000001001001001000000000000010000010011000000
00001000000000100000000000000000000011010010000000000000000000001000010001000101000000010001001000000
00000000000000000000000001000001010000000100000000000000001000000000000000110000100000000010100000100
11000000010100000101000001000100001111010001100000000001000000000100000000001001000100100001000000100
00010000000000001000000000001100101000000110000100010000000001000000000000000000000000000000010100000
00100000001000010000000000000010000000100000001000000000000000000010000000100000001001101000000000001
00000001000001001000101000001000000001000010001001000000000110001000000000000000000000000010000111000
10000010110001010000000110000100000000101000000001100111100100001010101000000000000100000000011000010
00000010000001000001001100000000001011100001000000010000010000000010000101010001000000001100000001000
01000100000001000000000010010000000000000100000000100100100000100000100000001000000110000000000000000
00100000001000011100000000011010000000101000001001100100010110000000000010000010001010100000000000000
01010001010000100010011000000000110001001001101100000110101001111000000011000000000000000001000100000
11100100100001001000101100010000001000000001010000010100010000110000001110000000010000000100000000000
00000001001000000011000010100001001000001000000000010100001000000000000100010000000000000000100100000
00010000010000000111001000000000000001000000000001000100000001000101001000000110000000100011011000000
01000001000000000000000001001000000000000000100000100111001000000000000000110100011011110000000000000
01010100000100100010000010000000010000001100000100000010000100000010000000000000110000000000000000000
00100100000100010000100001010000100000101001000100010000000000000101001000000100000000000000110001000
00000000000111100111001010110001100000010001000000110000010000000100101010000000000000000010000000000
10000000110101000000001000000000001111010010000011000000110100000000001000000000010000000000000000000
11000001100110010000000001100000000010000000000010000000011000001010100100110001000000010001000000000
00000010000001001100000000000100010000000000001000000000000010000100000001000001000000001001000000000
00000100001001000010000000000001000100000010110010010000010000010100000011010000100000000000000100001
10000001011001001000010001001001000000010100000000001000000010101010000010000001000100101000010110100
00100101001000001000000001000101000000110000000000100000101000000000110000000000000000000000000001001
00100000000000000010000000000000000000000000000000010000100000000000000001000000010000000000101000100
11001010001000000001010000001000000000001000000000000111010000010000000100000100000000000000010100000
00001000001000000010000010010001000000000001001010000001000000000100001001000001000100100000000001000
00000001100000000000000010000000001000000001000000001010000100010000000000000000100000000000000000100
10000000011001100000000000000010110001000010000000000000100000100000000100000000001000000000001001010
00000000000000010000100000000000000000001101000100010101000001000000101000000000101010000011000000110
01010010000000000000001000011000010000000000100000000110100010001000000000010001000100000000010000000
00000100110100000000011000000100000000000000100000010010100000001001010000000000100100111001000010000
00000000110011000000000101000000000010001000001000100000100100001101000000100000110000000000100000000
10000001010000001000000100000000100000010100000000000100001000000001000001100000010000000000110000010
00010000001000100000010000000101100000000000000000010000000010000000000000000000100001100010000000000
00100010100110110001010000000000100000100110000100000000000000010100000000010010001000000000010100000
00101011000000000001000001000000101100000000000001010000100000100000001000000000111000000000000101000
00000000100110100001001000000000000000000000000000000000010000000010001000010001000000000001101000101
01000110000001010000000000001110010000000010100000000000000011000000000100001110001000000000000000000
01101000000101110010011101001000000100000000100001000000000000000010000000001000000010100000101000000
00110101000100001000000100000000000010000001000000100000000110000000001000010000000000000001000000111
00000101001000010000110000010000000000100000100000000000001011000100000010110000000000000101000010000
00000100000000010000000100010000000111100100000001000000011001001000010000000000000100000000000000000
00000000000001000100100000100000100000000000011100001001000000100000110010000000010000100000000000011
00000010000100110110011000000000010000000000001000000000000000010000000000100011100000000001000001010
01010000000000100000000000000100000100001010000001000010000000000010000000001100000000001000000000000
00101000000011101000000000101100000001000000010000001010111001010000000000100000011000000000100000001
00000000000000100010010100000001010010011010001100000001001010000010010100011000010100000000000100000
00000000000100010000100100000001100000000100000110101000000000000010001001100010000001000000000010010
00000000000011111000100000000000010000000110010000100000000000100000001100001000001010010000010001011
00001000001000100000000000100010000000000000000000101000010001010000100000001100000000100010000000000
01000000100010000100100000000000000001100010000000000101000000010000100010010010010000000000001000001
01000001000001000100000000100000001000000000000001000000010101010001000010110100000000001000000000010
00000000001101100010000001000000010000000000000000000101000000100000000000000001000000000000000000100
00000010010000100000001000010001100000001110010001001001000101000000000010010010000100000000000100011
00000010010001001100000010000000000000010001000001000100000001000100000000000000000000000000001101110
01000000010001110000000011000100000010000101000010000001100001000000100000010000100000000001100000000
10001000000000000000001000000000010000000000000010001000000010000001100011000000001101100000000101000
00100000001000001110000000000100100010000000000010000100000100001001100000000000000000010000000010001
01000100000000000000000001000000001100000000000000000010000000000000000000100101000010000000100010010
10000010000010010001001100010001000000000000101000000110000000100001000000000000000000000001000000000
00100001000001000100001000000000101001000100000001000001000000000000110010000100111000000010001000000
00100101100000010000010000000011011000001000000010001000010000100000000010000000000000011000000001001
00100101000100010000000000000000100000000001000100010000100000000000000000001000001000001000100000000
00001000000000000001011100001001000000000100001000100000100000001100000000101000110010011100000000100
01000010000000100000010000000110000000001000010000110100010100100000000000000000100000110000000100001
00000001100000000001000010000000111001000010000000000000000000000110111000000010100000001000100100001
00010000000000000000000100011100001100000000100100000000001011000010010000000000000011000010000110010
00000000000000000000000000100001000101000100000001001100000010000000000001000000000000100000100000001
01001000000100000000000000000000000010100001000000001000000001100101010100000011000010000000000000000
01000000000100000001000011001000000100000000000000000101000000001011000000010100000100000100010010000
00001000000000100000100000000000010000000100100100000010110000110000001000110000000000000011000100000
00000001100001100000010000000001001000000010100000110000010000000000010001100000000000010000001011100
00100000110000010000000000000000011000000000000100000011010001000000000011100000000000000001011001000
10011000001000000000010100011000000101000010001100000010010000001000000100000010100001101000001001000
00000000000000000000000000100000010110000000000000000000000100000100000100010000000000000000000000001
10000000110001111001000000001100100100000011000010010000000000011000000000001001001000111000001000000
00000100000000001000000100000101001000010100000000010000000001100100001000000010001101000100111110000
00000010000000000000100010100000010001000000000001100100000010010010010000110000001000000100000001000
11100000000000000000000000100000000100000000000000000000001000000000000110000000000000000000101100001
00000000100101000100000101000000010000100110101001010000000000011000000000101000000000100001000100010
00000000000101100010000000100000000101000000011000000110010110000000101100000000000001100000001000010
00010001000001010010000000100000000000000100001000011000000000000000000010000100000000000001000000000
00001000000001000000000110000001001001100001000100000000000000000010000000000000000000001000000010000
00000100000101000001000000000001000001001100001000100100010100000000001100000000000010100001001010000
