00100000000101001000010110100010000000000000001000000000100000000000010100000001000001000000110000100
00000001011000010101000000000100000000000000110100000000000100000000001000000000000000001110011000000
10000001000000010010001000100001001000000100000000000000001101001110000001000001010000000001110000000
00111011010000000000000000000000001010000000001000110010001000000110010001100101000000000000000000001
01100000101000010000111000000000000010001010000000010000000000000000001001100010101000000000000000001
00001000011011110010000100101000001000000000000000001000000000000000000000011001010000001000000000000
00000000000000100000001000100000000000100000000000000000000000000000000000001001000000100000000100000
00000000100101100111100000001000010000010000001100010000000110001000010100000010100000100010000000100
00000000000000001000100000000010001110000000101010000110000000000110110000101001100000011000111010000
00000000000001000100000100000000100000000010000001010010000010001000000000101011100001000000001011000
00100000000000000100000000000000010010000000010000001000111001000000101000000000000000000010000101000
00010000100000000101100001010010001001100011011000000000100000001001000000000000000000010000100000000
01000000000000000000000000000001000000000010000010010001001000000111001000110000000000001101000001000
00000000000100100001000000100000001000000000110000010000110000010000000000001000010000110100100000000
00000000000000000000000010100000010111100000000000000000000110110000101110000011000000010000000000100
00000010000000000000000000001101110001000000000001000010000010000100100000000010000000000001001101001
01000000001000000010000000001010000001001010000000000000000000000100001000000000010000000011010100000
01001001100010100010000100010100010000000000000001000000000011001011100001000000100001100010000100010
01000000000000010011000000000000001000100000000000000000000000000100000010100000100000000000000010000
00000001000100000000001000000000000010100000000010001000000000010000011100000000000000000100000000000
01101000000000000010000001000111000000001000000000000010000100001000010000000000000000000010001001010
00100000100000000001000101111000110000100000000000000010000010100010100010001000000000100000010000001
10000000111110001010010000110000000000000000000000000000000000000100000000100000000010000000000000000
00000000010000001100001110000000000001001000101000110000001000010100000000100010010010000000010000000
00011010110101010010100000100000000000000000000100000001001010001001000000010000000010101000010000000
00010110000000100000100000000000000010000110000000000100000000010000000000010100000000001000001000000
00000000000000000000010000001011001000000000001011000100000000000000010000000000100000001000100010001
00100000000000000000010000100000000100101011000100010000100000000100000000000001000000000100100010100
01001100001100000000000000000010000110000000000000010010000001010010000000010110000000100000000000000
00000100001100010001000001001000000000011000001010010000000000000110110101001000000010010000100110000
00101010000000000100000000000000000000000101010010010000100100000100000010000001010010010101001000000
00000000000010000000000000000000000000000000000000110100000000000000001000000000010000000000000100000
00000000001100100000001001000100001000000010001010000001000001010000000100100000000000101010100010001
00000010011001110100101000001000000000000000000000010000001110000000000010100000001000000000001000010
10100000011000000000100000000000000000000000100000100000000001110000110000000000000100000100000010010
00000000000000000000100000000001000011000110010000010000000000000111010001000001000110000100000010100
01000101001001000000000000100000000000000000010010001000000000000000000000000111000000011000100000101
00100000000001010100001000101000000000001000000001010000000001000100000010000010000001000000100000000
00001001001010000000100000000001001100001000010000010001001000010100000000000000000000001000100001000
00000000000000000000010000000000000000100011000000000000000000101000010000000000000010001101101000010
00000010000000110000000100000000000001100000000000000010010000100000000100000000000011001010101001000
00010000010001010001000001000000001100011010000010010010000000000000000000000110000000001000000000010
01000101000100000000000000000000000000100000000000000101000000101000001100000001010100000000010010000
10000000000001000011000000000000010000000000000000010000000000010100010100000100000100000010000000000
00000110000010000001000000000100000001000100000000100000000000010101010000000110001110010000000000000
00000000010001000001001000011000001000001000001100001000000001000010000101001010001000010101001100010
01100000000000000101000000000000101001000010100010000000110011000000000001100000100000010100000010001
10000000000000010000000010101000000000000000010000010010100101010001010000001100001000100000000000100
00001001010000000000000000001000000000101101000000101010001000000010000001000000000010101010010001000
00110100010000000011001100010100000001000000000100000000000001100100000010000110100000000000000010000
10101010001100011100001010001100110100001011001000000001011001010000000000000000000011000000100000000
01000000001000010000001000100001000000000000000010000100000010000000000010011000000000000000010000000
00010000000000000101100000010001010001010001001000000101100000000010001000000000100000000010000000101
01000001001001001000000000000000000001000000001000001000000110100000001100000000000001100100000000010
00000000010101010000010100000100000000000010000000000000100000000000100001100001011000000100010010010
00001001000000000000100010000000001000010000000001000101000000000000000000100000100010000000001000000
10000000000010000001000000100101000000001100000001100100000110000000000000000010010001000100001000100
01000010000000000001000010000000000010000001010000000000000010001000101110001100000000010000011010000
00001001000001000100000100110000101000000010000000000000001000000000001010000000000000001010000010001
00010000000110000101010000010001000000001000000000100000000000000100000000010001000010100001000000010
00000010100001010100010010000000000000100000000000100001100000000000000000000000000101001100000111100
01000000100000000000000001000001010000010000100000000001000100000000000010000000000001000010001000000
00000010010100000001000000000010000000000000000000000000001000000000000000000000000000010110111000000
10000110000000101000100000001000000001110001100000000000000000000100100110111000010000100000000000000
00100001101001100001000000000010100000000010000000000011000001010000010000010110000000000101000010000
00000000001000001100001001100001000000000000000100000001100000000001000000000000000000111000000000010
00001010000000010000101100101010000000000000001000010010000001000010001000011000100001000000000000000
00000010100101100100000110010000000000000000100010000010100000001000000000000000010100000000001100010
00000100000010011000000000000010010000100001000000000000000000000000100100100000100000010110001001000
00010100000000010111000000010000000000000001001100000001000100000000011011000000000000010000000100100
00010000100000001001000000000000010000000010101000000010101000000000000000100000000010000000000010000
00100000100000000000010000000000000010000000000010000000110100000000010000000000000000110000100011001
10000000000000001000000000100010010001000001100000001000000000000000000000000000100000100010000000000
00000000000011000000110000000000001101000010000010010000100001001000000010000100100010100000011000000
00100000011101101100000000000100000000100000000000000100010000011000001000000101000010000000000000000
00000001000011000101010000100100010001001000010100000000000100000000011010000100010000000000010110010
00001000000000000000000010000101000000010010000001000001000001000000101000000000000000000001000110000
10100101001000000000000100010110011000000011000001000010000000000000000000101001000000000000001000000
10011010100010000000010000010000010100101000100000000000001000101000010000000000001001100000100000000
00100010000000001000100100000101010000000100100000000000000000000000000000000010001110000000010001000
01000010101000000000000000000100011100000010000000000010001000101010000100000000010000010010000000011
00001000000000000001000000000110000000100000110100000100000010010001100000000000101000010000110010010
01000010110000100001000001110010010000011010010001000000000000001000000000110100000100000010010000001
01010000101000000000000010001000000000100000000000100000000000000000000000000100100100010000000000011
10000000000011110001000010010000010000011000000000001010000000000000000101100000001100000010000000000
01000000001001000000010010100010010000100000100010010001001000000000001010100000000010001010000000000
00000111100010000000000000001011000000000001100000000000000000000000000000010010110000000000110001000
00100000100100000000100000000010000100100010000000101001100000000000000100001000000001000101000000000
00011000011001010100000100000000000100000001000000100000101000101001000010000001000000000100000001000
00000101001000000000000001000000000101000000001000101001000000000010001000001010000011000100010001001
00000001110110111000000010001100000000000000000010000000000000000011000000000000000000000000010000111
00000111000001000000100000000011001010000000000000100010001100000001000000001001100000001100000100000
01010000000000001000000000000000000000000010000000000000010000000001000110000011001001100010000000000
10000110000110000000000000000000000000001100100010010000100010001010001000101001001000010000000000000
00100000000110000000011000001011000000010100110100000000010001111000101100000001001000000010000000000
00001001001001100000001001000001011101001000000000000001010000000001000000000010000001000010000100000
00000011000001001000001001101010000100000100010001010000101100000010000000100000001000000000000100001
10000010100001000000000100000010100000101000000010000000000000000011000011010010000100010000001000001
00011000000001000000100100000000100000001010000000000100000001000000000001011001000000001011000000000
11000100010000001100000001100100000001000010100110100000000000000000100101000000100100000000100001000
00000100000000000010000100000100000100000100101100100010000100100000011000010010001000000000000000100
