00101110100000010100000000010000000000000011011010000100000000000110000010000100101000000010100000101
01010000000101001001001011000100010000001000000001000001000010010100000000000000000010000100000000001
00011001000000000001000101000000010000000101000001001100100000000000000010000001000001000100010000000
00000000010100011000000000000100010000000000000100000000001010000100000000100000010010011101000001000
00010010000101000000001000100101000000100010101000100001100001011001000100000000000000010000000010000
10000001001000000100010010000000010100010000000010000110000001000000010000000010100010000010010001000
00000000001100000010001000000001000000100101011001010001000000001000001001100000000000000000000100000
00100000001000010001000010011000000010101000000000000010000100000010010001100000000000010000010000100
10000000000010000001000001001000100000000000100101000000000000000000101000010100010000000000000000100
10011100000000000000101000010000001010001100010000001100010000001000100000001100001000000111000000010
00100000100100000001000000000000010100001000101000000000100101100000100000011001001000000000100000000
00011000000010100010000000010100001101000010000001110000000000011101001000100000001010100000000001000
00101000000001010000000000000000001001000000000010010100100100000000001000001000010000000100000000001
00001110000000010000000000000000000101000001000000000001000001000000000001001010001000000000100000100
00001000001010010110100000000000000011010001000000000001100100010000100100110000000100000001000000101
00000000000000001110100000000010000000000000000000010001001000100101010000000010001000000000010000000
00010110000000001000001000000000000000000000000001000000000100000000001010000010100000000000100001001
00000000101000010000101000000000000001000000010001000001001000100001011010100000000000101000010000010
00010000000001000001011100100000000000100000000100010000100000000001100000000000000000000011000000000
00000100000000000000001010100111000001000000000011100010000000000000001000010010000000000000000000000
00001000000101000100000000000000010001001000000000000000001100010100000000001100000100001000000001010
00000010101000000000000011001000000000000100010000000101000000000000000001010000000000000001000000001
00010000000000010001000001000101000000000001100000000011100000000000000000000100010000100000001000000
10000000000000111000000100010000000001010000000011100000100000000000000100010110001000101101110011001
01100000010100000000000000110000010000011000010001000000000010000000000101000100000000001100000100000
00100010000000000000000100000000100000010001110001000101100000000000010000001100000001010001000010010
00100001000000000010000000010000000100100100000101001000000101110000000100100100100000000000010000000
00000001000000010000100100010000000000000010000010000000010100000000000000000001000010011000100010100
01001000000001000001000000000000001000100000000000000000000000000000000011000000000000100000011000000
00011001010000100010000100000000001101000001100010000000000010100000000010100000000100000000101000000
00000010001000001001001000000000000000000000000010000000100000001000010000100001000000000100000111000
10010000000000100000110000000000110000000000101010010100010010010000000000010000000011000001000000100
00001010000000100000000000001100000100001010000000000000000000000000010000000010000000000000010000000
00010000000010000000000000010100010001001111010000001010000001000010010000000000101000000000000000110
00000000000010100000000000000101010001001000001101000000000100100100010000100000001100001000000011110
00000000001000000010000000000000000000000000000000000010000010000000010000010000000000000100000000010
00000000000000000100010000000000110010000010100101000000000110000000000000000100001000000000100000001
01001000010000000000001000000101000000000000010010000000000010010000001010000000110000000000100110001
00000000000000000010000000000001100010000101000000010100101010011000000000100001100000001000000000100
00000010111000000010001000000100100010110001100000110000000000000010001001000000000010000000000110000
00100010001000001000010010100010001100100010010000011100010101000000000010000000000001000100000000100
00000100000101000101100000100010100000101000011000000000000001000000000010000000000010101000000000100
00000001001000101100001000000000100000100010000100000000000000000100000000000000000000010000100010000
01000000000000010000000011000010000111000100000000000000000000000000100001000010101010001000000110000
00000000000000001101001000000000001000000100000000000000010011101000000000000000001000100000000000010
01010000110001100000000000000000001000000000000000100010010000010000100101000001000010000000011000100
00000100000000100000001000000000001000010010000000000011101010001000111000010000000000000100000010111
10000000000000001110000000000100000100001001000010000001110110000000100000000010000011000010100010010
00000101000000000000100010000000000000000001000001010010010000000101110101000001010000001001000000000
00000000000000010100000000000000000000000111011000010101010000000000100000000000001000101110000011000
00001100000110000000000000001001000010000011011000000000010010000100000000000000100101001000000001000
00000000010000001011010001010010000011000000010000000000000001100000100000000000001000011001010000000
01000001100000000100100000000000010101000000000000001000100000010000101000001011000110001100000100100
00010000000000000011001010000000010000000000000000000000001000000000010010000011000000011000000100011
00101001110010001000100001000000000000010011011000001000100110000010000110000001000001001000000000011
00010000001000100000001000000000010001001000000100000000000000000011010000000010000011000000000001001
00000000001000000000000000000000010000000000010010000000010000100100000100000100011001000100001000101
00011101000000000000001000100000010100000000010000000001001000000101000000000010000010000100000011000
10010000010100100101100000000001000110000000000100100001100000000000001100001100000000000000000000001
00000101100010000010100001000001000001000000000000001000001100000000000100010100100011000001100000000
01000000000000001000100100000001000100000000000000010100100100000000000100000000010000001010100000001
00001010000100011000000000000001000000100000100000000100000100000000100000000000001100000000000000100
01000000000000001101100000100100010010000000011000001001010000100110000000000111000000101010000001000
11001100100000000100010001010000001000000010111010111000001000010101000000000010101000100001000001000
00010000100000000110001110010010000010001101010000000000000000010001001000001100100000100000010000000
01001010000001000000000010000000000100000000000100001000000000000000101100000100100000000000100001000
00100100011000110000010000100001000001000001001000000001000000100100000010000011000100010000000000000
00010010000010100000000010010001100100000000100110001000000000000110001000000000001100100000000001000
00000110000000000000001010000000011100000000000111010000001001100000001000000001000001000000000000000
00000000000010010000000000000000000110010010100000010010000100000100000000000011000010000100000000001
01001000000001000100001000000000000000001001000000110000100010000001001100000001001000000000000100000
00000010001000000000000000000000000010000000010010000000010000000000011000000000000000001000010001100
00101000001010001000000000000101010000010000110100100001000010100000010000000000001000000000010000010
10000001000000010001101101000000000001000000000000000001100100000100000000000000000000000010000000011
10001000101000001011000001100000000001100010000010000011011100000100001101000010100000000100000000000
00000000000000010000001000100000011000001000000101010001001000000000000000010000010000000000000010101
01000010010100010000000100010000000000101000010100000000001010101010000000000010001011000000000000010
00010100010000000000000000001000110000100000110000100010000001001000101001010000000000001000101010011
00001110000001000100000010000010000000111000001011000010000001010001000100001000000000000000010100000
01011100000000000000000000000000001011010000010000000001100010000100000010010000000000000101001100010
00010010100000100000000000000000001101000000000000001000000110001000000100000001000001101100000000000
11100010000000000000000000000000000001010111000010000000000100000100000100001010000000000000000000000
00101000000011011010100010000100010101001000001000000000000000000010100000000000000000000100111000010
10000000010000100000110000000101110000000010001000001010000000001000010000010000001000010000000100001
00000010010100001010000000000010000000011000000110000100001000000000100000000000000110000010000001110
01000110000000001000010011000010001000010010010010000100000000001000010000001000011010000000000001000
01000000110000000000000000000000000010001000100001100000000101000000001000110010000110000000000100001
00000000000000000001000000010100000000000010010000100000000011000000000000000000110101111000000001000
10100000000101000100000000111010000000000100010000000000000010000000000000100000010000000001100001000
11010100010000000111101000001000000000000010000100000001001000000010110000000001000000000000010000000
00000000001000000000000001001100010000000000000000000000001000001000000000010100001000011000000001000
01010000111110100000010000001000000000010010000010000000000010000000000000100000001000001001000101000
00000000000001000000110000000000100000100000000010000000001010101000000001000100100000011000010000000
00000000000010111001001000010000000000000010111010000001101000000100100000000000010000000000000000010
00001000000000100000000000110010110100000000010000001100000011010000000000000000011000000000000001000
01000000010001000010000001000000000000001000100000100000010100000000000000000000010001111000000000000
01000000000000100000101010010110001000010000000010000010100001100100100000000100000010000000000000000
00000000001010000000010001000000001000100001011000100000100000000000000100000000000010000000000100001
00000001000111000010010000001000001000000000000000000000000000001000011001000000010000100010000010110
10000000000000000000000000101000000010010000000000000011000100000010011111010101001000000000000000011
00000000000010011000100000010000100001000000000000000000000000100000001010000000101000000000000000000
