00001000000110000000000000000000001110100101000000010000000010000111100100100100000000000000100001001
00011000000000110000000000100001000100000000010010000000000000100001000000100000000000010000000000010
00100000010000100000000000000000010110101000010010000010000000000000000000000000000000000100000010101
00001000110000100000111000000000110000000000100000000000000000000000000000001000000000000000000011101
00100000001001001000000001000000010001000000000000000001110100100000010101000100000000010000000000001
00010100000000100000101000010000000000000110001001001000011000000000100110000001101001010000000000001
00000000001000000001000000001001110010000000000000000001000001000100000001001000000000100000000000000
10000000100000001000100000000000000000000100010100000000000100100000011001000000100000100000000001010
00000000000000000010100000100100010000110000000100010001010000000001000000000000000001001000001000000
00000001110000000000000000010010100001000010001000100100001010000100010101000000100000101010001000000
00001000000100100001000001000001000101010010000111101010000000001000000010001010000001000000000101000
00000000001000000000101101001000100101001000000011000000110000000000000000101010000101000000000010000
01010000001000010001001001000010001001000010000000100000000000010100100001001000011100000010010001000
00011001000000001000101000100000000000000001000001000000000000000100100000001001000110000000100000100
00010011000000000010010001000000000000000000000110000000000000000000000000000000101001000010110000000
00100000110001000001001000011000000010101000000000000001001000001110000000010100001000100100000000100
01011000001010000000000100101010011010010011000000010010000000010000000100000100110110001000100000010
01100101000010010000001000000100000100000100010000000000000000011000001000001000000001001000000000011
00000000110000000000000010100000000000010000001000010000001000001000100010001100001001000000000000010
00010000101100010000001001100000101000000000011000000000000000100000110000000001010010000100000000000
00000010000000001000001101110001001010000000000001000000000000000000000011000001100000000010100000000
01000000011100000000011110100000001000000100001010000000000001000001001001011000000000000000001001100
01000000000000010000010000000010100001000001100011100010010000010000001000111010110000000001000001000
01000110000110000001001000100000000000000000100001000100100000000000000000000000000000000000000100001
00100000011001000001000000000000001000000101100000000101010001000000000010001010000110000100010000000
10001000010000100001000000000011000000110001101001010000000000000010000001100101001100100000001000010
00010100000000100001000000000100010000010010000100100000000000001010010000100000001001000100100010000
00000000000000000000100000010100001000000010010010010001010000000010000000000100000000100100000100000
00000000000000010000010000000100001000101100010000010100010010010000000000011000000001010010001000000
00000000000001011000100101000000001001000000000000000101000001000000000000001000001010000011000101100
01010001000110000101110100000000000000010010000001000100000010000010000001011000000001001100101000000
00000001000000000000001000000100000000001000010000001010011000001000000110001100100101000010000000000
00000000000100000000011000100100000000000000000001000000110000110000000000100000100100000000001010000
00101000000010000010001100100011000000000001001010100010000000011000010000000000000010000110110100000
10000010000000001000000000100010101000001001000000100010000001001010000101010000001101001100010011100
00001100010110001000100000000000000000000000000000000000000000000100100000000000110000000000000111010
00010000000011001000100000001001001100111010000001000000010001001000000000000000001000000000001000000
00000000000001001000001000000000100010100010000010101000000001000000010000000000001000000010100000001
00000000000000101000000010100100010010000000000000010000100000000000010000000001110100000100011101000
01000000100100100000000001001000000000000000000000001100010000100010010100000000011000000000000000010
10010000001000100000000001000000000010100001100001000001000000010000000100000000000000000000000011000
00000000100000001100000000000011000110100000010000010000001000100000000000010000110001011000110000010
01000100100000000000000000000000011000000000001001000000000010000010010000000011010001000000100000000
00100100010100000010010100010100100000000000010000010100010110100000000000101000000000000000010010100
00010110000000010001001001001101000000000000000000000011000100100100000101010000101100110101000110101
01001000000000000000100000000000000000001100000000000000001000010000000000100010000000000000000010000
00010100010001000011100011000000101100011110001000000000000000010000100010000000000010001000010000000
11000000001101000010001100101010000000000000000000000000110000101000001000011000000100001000000000110
00001100000000000011000000000000010010100000000001010011000100000100001000100000000000010000001000000
01001000010001100100100000000100000001000000001000000000000000000100000000000100000010000000001000000
01010000001100000000000000100100001100000001010000000001001000100100000000000000000100010000011000010
00010001000001000001001000100000101010000000000100001010001000000000000000001000111000001000001000000
00100000000100000101111000100010000000000000100000000000001001010000001010000000001000100010100000000
10000001100000001000001000101001100011010001010010000001000001000101011001000010001000000001010000000
00000011010000100000000100000000000001010000000000000000000000001001001000010000100000001010000000001
10010010100000000000100001100000000100000010011100000100000010000010001000000000000000100000101111000
01000000010000000110000100001000000001000101001110000011101001010001001111000100010000000110101000000
11000001101000000000000010000110011000000000101010010000001000000000100000000000000011011100000001001
10110000000011001001100010000000001000000000100000100000000001000000010000000110001011110000000011000
10000010000000000001000000010000000000010001000000000000010000000000000000000000000000001000000001000
00000000000000000100000001000010000000000000100000110000010100010000100100000011101000000000000000001
01000000001010000100010010000100000100000000001000001010010000000000000000001000100000100100000000001
00000000000000000000000010100000000000000010110000000100110000000000001101000001000100000010000000000
00010000000100001000000010010001000101010000010000000000101000000100001010100000010000000111000000011
00000100000000010010000000100000010000010000110100000010000110011001000000000000110011001100100000010
00000000000001100010000000001000100000000100000001100001000100000000000000010100100100000001000010000
00000110000000100000100100000001000100000000000000000010100001100000011101101000001000010010000000010
00000000000001000000000100010110001100000000010000001011100000010101000000010000001000000000100000000
10001010100000000100000100001100000000001000001000010000010000100000000010001001100000101011100010010
00000100000000000000000000001100010101001100000010000000100000010001000001000010010010000000001010100
00000000000010001000000000010000000000000000000000001001000000010000100010000000011000110001001000100
00010100100001001000000000001101000000110001001000000000100000000000001100011000010100000000100001111
00100001000010000010000001000101000000000100001000000001001011010000000011001000000010000001000001000
01000000000001000100000000100000000111000000001001001000101000000010000000000001000000000000000001000
01001000000010000000100000110100100001100100000100100100011000100100000100000100000000000010100000000
00001010000000000010101000100000000000000000001001010000000010000000100001000000000000010000000010001
00010000010100010100000000000000010000000000001000010100001000000010000010100010000001111000000010001
10000000000011000000000000100100000000000000000000000000101000000000000001100000000000100000111000100
00110000010001000110000000100000001000000000000000010101111010000000000010010000010000000001001010000
00000000000001100000100000001000110000000000011000010000100011010001000100000000000100000000011010000
00001100000000000000000010101001010001110000000001000010000000000001000000110000000000010010101100010
00100000011001000000000101000100000000000100000000001000000000010010000000000010001001010000010000000
10010001010000000000000000000100001110000000000010010010000010000000100000000000010010001000000000000
10000000000001000000000000000000110000100000000000000101100000000000010000000001001000001011110010010
00000000010000001100100000000000000000000001010000000010000100000000000000000100000010000000110000000
00000000000000011000101010000001100110100100010000000000000000010010110000000001000000000000000001101
00010100010000010100001010000001000001001100001000000001000001000000010010000010100100100000001010001
00000001001000000000010000000000000000100100100100000101000000001000100000000000000001000000000000000
00000111000000110110000101000101010110011000000000000010000000000000010000000000000000100000000000000
10110000011001000000000001000000000001010000000000010010000011000110100000000001010000000010011010000
10001001100100001000000010000001000000000000000100000010000000000110001010110010000000000000100100000
01001000000000000111100000010001000000010100001000000000000001011000000000000010000000000100000001001
00000000000000101000010000000000000000000000000000000000110000000011000000010001000100111010010001000
00000110000001000000000000100000000001000100110000111110000000000000000000000000010010000011000100000
01000000100100000001000010001000100000000100001100000001100110000000100100010000011000000000110010000
00000011100100000010110100000000010100000000000000100100001000000000000100010100010010001110000100000
11000001010010110001000100100000000000011000100000000001001001001000001000010000000100010001010000101
00001000001000000000001000011001001001001000000101101000101010000001000000000101001000000001100001100
00010111000000000000000000001000000000101100000000000000000001100001000000000110000000000010001010000
01000000000000000000011110010010000000000101011001000010100000000000000000001010000000100011000010000
11100110000000011101000001000110100101001000000010000000000100000000100000000000010000100000010010000
