00010000010000101000001010100010000010010000010000000011001000010101000000100000000000010001000000110
00000000000010000000101001001011010100100000000001100100000000100000100000100001000101000000001001000
00100010101000000000000000010000000000000000000001001001000100000000010010000000010000010010111100000
01000010100001000000000100000000000010100010000000000010000100001101100010000001010000000000000000010
00100001000001001000001100000000100000000001000010000010000000000000000000101000000100000100100100000
00001000001000000100000100010000000000000010001000100000000000000000010000010100100000000000001000000
00000010000000000001000110000000000110000000100001001000100010100000100001000001000000100000100001000
00000101100000000000001000000001000100100000010010011000000000010100100000000000000000000000000001010
10000000000100100000100100000100111010001000000010000000010000000000000000001000001000000000000000000
00100000000000100000000001110000000000000000000000000001000010010001000001010000000000000000101001000
10100110000000010000000000000000010010000001000000010000010000101000010000100001000000010000001010000
00000000000000000010000000100010000000000000000100010100010000010000000010000000011010100001001011000
00101000000000000000110000011000010000000010000000000011100000100000000000000110100011000010000010000
00001000000000000000100000100001011000010000001000100000000000100100000100000000000000000000000100010
00000000001000000100000100100000100000000100010000000000100000001011000010001000010000110000000000000
00000001000001000001010010100000000000100000100010000000000000000100001001000000000010000001001010101
00010101000000001101000000010000000001000000010010000001000010001000100000010100000000100000000000100
00000100001000010000000100001010010101011100000101101010100000100000110101010000110000000000100010000
00000001000010000001000000011000010000000000001011000000011001000000001100000011000000100000001010001
00000001000000000000000011000000010000000000000010000000000000000000000001110000000001000010000000001
00010000001010000000000000001000000000010000000100001001001000000001001000000000000000100100000000001
00000000010100000000000000001000010000000000000010000100000001001001000010001000100000100000010100001
00000100001010000010000100000000100001000100100110100001001110000001001001010000110000001100000011000
00100000000010001000000000000000000010001000000000000000000000001110001100000000000000000001000000100
00000000001001001000000000100000000100000000110000010010100100010000000000100011000010000000000000010
00100100100000000100100000010000000001010000000100000000001000000000100000001000000000000000100011000
00000100001001000111000000010001000010010000000000010000000000001000001000000000010010100000000000000
10100001010000000000010000000010000000100000000001100010110001000000000000010000001000001100000010000
00000000000010000110000100000001000100110000000010000100010000100011000110100010000000110100001100001
00000000000000000010000000000000001000010000010000000000000010000011100001011100000000010000100000011
00000000100000000001100001000010000000000010010010000001010000000010000100000100100011000000000000001
10000000001001000001000000010100000010100000000001011000010001000100011010000100100010000000000000000
00001000000000000000000001000100000000101000000101010000001000011000010000000000000000000101000000000
10000000010000001010100011010011000000001000110010001001000000010100000000000000101101100000000000000
00010010000011000001000000100000100000010000001001100000000001000000100000100100000001000010000000000
00000000001100000000100000000110101000100001001011000111010000000000101010010000000010100000000000100
00000000000000000111000000001001000001011100000000010000011001000001100100000000000100001000010000000
00010100101000000000000100100000100100010000010000000100100010001100000100000101110000100000100000001
00001100000000000000000010000000100000000001000010000100001100001101000010000000000010000110000000000
00000000000000001000011010000110000001001000000100000000000000000000000001000000001001010000000100000
00010000000011000000000100000011001001000001010010000001000000000000100010011000110010000000001000001
00100000000000100001100010001000001000000000000000000000000000011000000000000000000001010000001010101
00000001000000001011010000000010000010000101100101000000000010011100000100000000000000000001000000100
10000000000010110000100000000010000100101000110000000001100100000000010000010110000000000000000000001
10000100100001000000001000000000001001100010000100100000000001011010000000000000101000000100000000100
00110000000000000000000000000000100010000010000100000001100000000010010100000000000101000000000100101
00001000101000000000000000010100000000100101000011000100000100001010000001010001100000000000100110010
10000010000000000000101100111000000000010010001000000001101000000000011010001000000110000000000000000
00010101000100000100001001000100100000001001000001001000010000100100000010100000000000000000000000000
00000000000001000000100000000000001000000111101000010100010010000010110000010010000100100000100100010
00000000100110000010000000010000000000000100000010000001000100000100010000100100100000000010000000000
00000000000000100011000110000010000000000000100000000000000000101000010000010000000110010010000010011
01000000010010010010000000001010101000000001110000101110000000100001000110000001110101010010001101010
00001000000000010001000000100000000000000000001001000000001010000000000100000000001000000000000000000
11000000000011100110100001000000000000000000000010100000000010100100101000000100001010000100010001100
01000000010000000000000000000000100000000000000000000000010000011000000000001001000000000001000000000
00001000000110100000001001000100100000000001000000000000000000000000110010100000000000001111001000000
00110000000010010010001000000001101100000010001000000110001000010100000000111100000001000000000010000
00000000000000100000000010000000000000100001001110000000011000100011000100100100010100000000000000000
00100000000000100000000000010000000101000000100100000000010000010010000001001000100000100000000000010
01000000000000001010000001001000001001001010000000011000001001000000001110001100000000000000000000000
01000100000001000000000000000001001000000000001000100010011000010100011011001000000100000000100110000
00000000000010001000000000010000000001100000000100001100000000011100100000001100101001000000000000100
01000010010010001110010000000001000100000000000000001000010100000010000100100010000000000000110001000
00100000000000100000100000001101100000100110000010000000100000000100000000100100000000000100100000001
01100000000000100001000000010100001011000101001001001101010100000000110000000100010001000000000000011
00000000011111000000000110000101000000100000000010010000010100011011000000000001000000000000000011000
01010010000000010110001101000000001101000010000010000000000000000000000010000001001100100001010000100
00001100000010000000100000000000000011000000000011000000010000000001000111000011011100001000000000000
00000010100000000010111000100100000101000000000001000010001000110011000000011000110100010000000000000
00000000000000010000000001010000001011000100101000001000100000000000000001000010100000000000100100100
10000000000110000000100000000001001000000000100011000000000000101001100000000000010000011101100000100
00010000010100010101000000001000010010011000000010000110100100000011001000000011010001101001001000000
00000000000100000010001101010000100000001001000010000100100000100101000000100000000000010001000000001
11000000010100000000001110001000000110010010010000000000000000000000000000001001000011000100100010100
00000010000010000001000100011101010010110101000000000100100100000000000000000000000101100010001000010
01100000000001001000100000000000000101000011010010000000001100000000000000001000000000000000010000010
00000000011000011000100000101000000010001000000000000000000001000011000001100000000000000000000000000
00000100100010100000000001000000000000101000011000001010000000000000000000100000101000101000000001100
00000001000000010000000001000110001000000000001000000000000011000011000001001000010000000000000001000
11000000010000000000000000000001000000000001000000000100000001000010000000000000001000110001010011000
00111111000001100010000100100000000000000100000000110000100010100000010010100100001010010001001000000
00000100000000000000110000001100000000000011010100001001000011000001000100100001001000000100000000101
00000000001100001100100000000010000000110000100000000100000101000001100000000010000010001000010000001
00001000000110010000100000000100100100000110010000000100000010000000010000010110000001001010000110000
10100000000001011001000000001001000000110001000000000000100000010000000000010101100110001010100101100
10001011101100000000001100101000000000000100000100000000010000000000000011110000000011000000000011001
01101000000000001010000000000100110100000001000000010000000000111000000000100010000000101000000000000
01000001010010100000100010000100000000000000000000010000000001001000010000100000011001000000100100000
01100010010000000000000110100010000000000000000111000000000000000001000000000000001000000111100000010
00000000010000100100010010000101000100001100000000000000001001000110000100000011011010010000000000011
00000000010101000001000010000010000100010000000000001000000000001001000010001001000010000100011010100
00000000011000001111000000011000000001000000100000000001000000001000000000010000000000000000011100100
00000000000000000100110000000000000100100000010110000010000111100100010100000001000000010000000111000
00100000000000000000010000100000000000100000000100000011100000001001000001001100011111000000000000000
00000000010000000001000100001000110000000000100001100100100000000100000000010000001000101000110000010
00010000011000000000001010000000000001000000000000000000001100010001000000000000000101000000001010000
10010110000000100100001000000010000000010100011000010000000011011000100000010000010000010010100000000
10110000000010000000010100000010010000000000010000000001001000010000100010001000010000100000100000000
01001000100000000000010000001000000010000010000000000000001010001010000000000000000000000100000000100
00000001010000001010000000000100000000000100001001000000100000101100100000101100000000100000011000010
