00001010000010000000000000000000000100100000000000010100000000001111100001010000100000000100000000000
00000000000001100000000010010001000000000011110000000000000000011001000000000000000000000000000100000
00000000010010010010000100000000000001000000000100000000000000100000000110000000111110000000110001001
01000000100001000000001000000000010000000000010000100010000000010000001000010000000000000010000000001
10000010100100010000110100000010000000000001000000000010010010001000100000000000100010101000000000000
01000000000000000001001010000000000010000101000010001001000000100000100000001010000100000000000000001
00000000100000000000000010010000000000100100000000100000000000000100100000000000000001000000000010110
10000000000000000000001100011000001010000000000111110000000000001000000000010100000000011000000000000
00000000100000000000100001001000000010000001000100000001000000000010000000000100000100000000001000101
01110000000000000100001100000000000000000000100000000100000000000000100001000000110110001010000010000
00000000111001001000100001000000000000010000000000010000000000000001000000000010000110001000001000100
00000000000000000000000000100000100000010000010110100000000000000000000000010010000110100000010000000
11010000000000010000100001000100000100000000000101010000100000001000010000000100000000000000000000001
00000000000000000011010010010100110000000000000000101000100010000000000101100000100000101000010000000
00001011001000000000001010100100010001000000000000010011000000010000000001000000000001010000000000000
00000000010010000010000000000010000000000000000110010100100000010000000000000011000000100001010010000
10100000001000000000001100000100000001000000010000000000000001000000010000000001000100001101000000010
00010100010000000000000000011000001000010101000010000100010000000010000001010000000001000001000000001
10111001000000000000011000000000001100000100000000000000000011000110000100100000000100000000000000000
00000000000010001000000101110000001010100100000101001100100000100000000100000000000001000000100001100
00100000001001000001010100000000001001000000000010000000001000000000010101000100000001010000001001000
11000000000000001100000000000010100000000001000000000011000000001000000000110100110000000000000011000
10001000000001000100000000000000000000001000000000000000000000010000010100001000000000011010011000010
00010001000100000000000010000000100000000001000100100010000000001000101000000100000000000000001000000
10010000000000000001010100000000010011100000000110010000000000111011000000010000000010001001010000001
00011000010000000000100000000001000000000000010100110010000010100010000000000000010010000000010010000
00000000000000000000000010100000000000001100110010000000000000000010000101100000001000000001010001001
00010010001001000100100101000000100000011000100000101000001000100000011000010000001000001000010000110
01000000100000000000010000000000000000001000010000000010001000010001001111010010011000000000011000110
00100000000000100000001001000000001000000000000110010000000010000111100000100000100010100001010000000
00000001000000101000000000111000000100000000001000010001001000010001000001000100001000000110100011010
00000100100000100111101000110000000000000001000010000000000000010100000000000000000000100000000000000
00000000001001000101100000000000010000010000000000000010000000110000000010000000000011000000000001000
00011100001011001111100000000000000101000010000000000100010000011000001010000000100000011000011000001
10001001000000011001100010000010000000000001011010100100000000000100000010000000000000100000101010000
01000100010010000001010110000100000010010010101010000100000000000001000000110101001010100000001000000
11000101100010010010101001000100000000100000000000000000000100000001000000001000010000011000000000000
10000000000000000011010000010110111000000000000011000100000011010000001100000000000110000110000010000
00001000000010011010000000100001000001000000000100101000010000000111000000000000010000001100000100000
10000100010010000100000000000000000001010000001000000000000000011000001000010101000000000000000000000
11010000100000100000000000000100010000000001000100000010110000000000010000100000000000100000000100000
01000101100100001000000000000010000000000001000000100101001101000000100001001000000000100001010000000
00011000100001000000000000000011000000000000000000010000000000011000000000100000011110000000101000000
00100000000001001000000101010000101000000110000010100000011000000000000000000000010000000100100000000
00010000101101010010000100000000000000000010000000001010001010001000000001000100000010000000000000000
00001010100000000000100010000100000110001100000000010000011110100000001001001000110000000001001000100
00001000000000000010000000010000100010000110001000000000000010000000000000000000001000101000100001000
00101000000000001000001001000001100000010000000000000011100000000100001000000000000100011000010001000
00000000000000000100000001001000001001000000001001000100000001110000000101000000000010101101001000000
00000010000001100101000000000000000000011000110000000100000011000000001010100101001000000000000000100
00000011000000110001000000010111010000001000000100010101000110000001000001001110000011000000011001111
01100000000001000000000100010000001010000000001110000010000000100100001010000000000001000100010100000
00010000001000101101000000000000000101100000000010000100000000010000001001000000000101001001101001000
10010010000001001000010010110000010010000000000000100010000000000010001001000000000000000001010000000
01111000100000000000100000010000000100100000000100000000000000000000000100000100001000110010010000000
11000000000000000000000000000010000000000000010000101100000001011000000101000000110100000001010000010
00000100000100100000001000010010011100100100000000010000000000010100000010000100000000000000100001110
00101000000010100010100000000000000000001000011000001000000100000000000000001000000001000001000011001
01001000000000000100000010000000001000010000000000011100000000001000001001001000000000101011000001100
00000000001110000000000000001000000100001000000000000000000000000000000101010000010000000000000000000
01010000100001100000000001000100000000000000100000100000000010001000100000000000100000000001001010000
00011101001000000001100001000001000000010000000000000010100000000000000000010000000100001001000100010
00101010000000000010000000000000000010010100000010100000000010100000001000000000000000000000000000000
00000100000100000000000101010100000010100100010000000000010100000001010001100000010100101000000001001
00000101000000010000000000101000000100000000000000000000000010001011001000000000000000000011000000001
10110101100000010000000000001000000000000000001000001001100000000010000110000001000100000000100010000
00000100000100100000010100100010010000000000000100101100000010000000001000000000000000000110010010000
00011000000000000000000010000000000000001000000100100100000001110000000000000100001101000010100100100
00000000000000100000110110000010000001010010011000000000010011000100001100000000100000000010001010000
00010000000000000000001000100000000100000000000001000000100000001001100100000100001000001000000000000
00001001001000001100001000100010000000001000000001100011000010000011100100100000100001000000010100101
00000010001000000000000010000110011010110101000000000011110000000000010000000000000000000110101101000
10001010001000010000000000000000000001111010010001100000011000000000000000000011000010010000000001101
00000000000100100010000000000010011100000000000000000000001000000000000000100000000100001000000000000
00000001011101000000000010100101000100001101010010010101000000000100001000000100000010000000000000010
00000001010000101000010000000000001000000000010001000000000000001101000000001000000010001000000001001
10101000000111110000000000000000000000001100010000000000000000000000010001010100010001010000000001000
00000100000000000000000000000011000000100010000000000000001000010010100000000000000000001100000001001
00000000000000000000000010000100000000010000000000000010001000000010000101100000001000001100000010000
00000000001100000000000000010000000000000100001010000000000000001010001000000000000000001000010000001
00001000000100000000000001000101011010010000000000000000101010000000000100110000010000000000010011000
10000000000000000000000000010100000000010100110001001000000110000001000100110001000101000100001000000
00010010100000010000000000000000011001000000001100011100010000000010000001000100000000000000000001011
00000000000000000000000000000010100100010010100010000001000000000000100000000000010001000000110000000
10000000001000000000001011011110000000000000000010000000101000010100001001000010000100000000000000001
00000000000010001100000010100001001001101011010101000101001001010000000000101000000000001100010000110
01100111001100000100000000100010000000011110000000011010000000001000001100010000000000000100110001101
00001000100000000000010000011101100000100001000010001000000011000100011001001100100000000000000010000
00001101000000100000001000010000010000110100100000000000010010011010100000000000010000010001110000001
00000100010101001000010010010010010000000000100001000000000110000100001011000100000000100000001110000
00000000011000101110000000011100000100000101000000001000000000010000010000000000000001000000001101010
10010000000000010010001000100000100000000100000000000000010000010010000000000000000000000000000000000
00000000000000001010000000000000000100100010000010000000100000100001000100010001000000001010001001010
00000001000000001000000010100000101001000000101000000000000000000110001001010001001000000101000011100
00000100000001000000001000000111000001001000000100010100000000000000110000010010000010000000000100000
00000110000000000100000010000100100000100010000010000110000001010011100001000000000010100001000000000
00000000010000001010000010000110010000100000011000000100000000000100111000000000101000001000101000000
10000001000010000100000000001100000000000000000000001000110100000000000000000000111000000000000110000
11000001010100000000001010100100000000000000000000000010000100010100000000011000000000110000100000000
00001000000000000010000000000000000101000010000001100011100001000000000000000000001000000000000000000
10010000000010000000001001000000010000000000100001100000000000001000001110010000100101100000000000000
