00100101001110000000000000000000000100000010100001000000000000000000100001000001100010110000100000010
00010000000000001100000000010000100001001000001010000000000000000000100001000000000000010001000001001
10100001000001110000000000001001000100000100101000010010001000000011000000000000001100001101000000000
00000010100001011100000100001010000000000000001000101000000000010001100001101101011000000000000000000
00000000000010011001000000000000000010000000000000000000000000000000000000000000110000011000000001000
00000000000000011000010110110000000010000000001000001001000000100001000000110000000001000000000000000
00000000000000001100100001000000000000100100000000000010010101000001000000010000001001010000000001001
00000010000100011100000000000000000000000001001000000000001000001000001000011010001000000000000110000
11000100001001001101100100100000010000000000000000100000000000000000001100001000101100000000000000010
00000000000010100000101001000000010001000011001010100010000000000001010010000000000000000000100000100
00000100100110100001100000000110000100010010110000000100000000010100000000000000000000000100000000000
00000000000110010000000000100100010110010000100000010000010100100110000000101101100001010100000010000
00100001100010001100000101000100100010000010010110001100000000010000000000010000000001000011110000000
01000001000010010100000100001110000010000000100000000001010000001000001000000000000010110100100001000
00100000100001110000000000000000000010000100001000000001000000000000000100000000001000001110010000000
10000100010100000001000010000001000100100000001110000000000000001000100000010001000001000110001011000
01011100001010000000000001000000100000100000010100001000000000001011000000000001000000000001011100000
01000100000000000000001001111110000000000010011000000001000000010000001000000000010000000000000000000
00101000001100110100010000000010010000001000010000000001000000000110000010010000001000100000000000110
00010011000100001011011000110110101001010001100110010001000100110000000010011000000110100001010000001
00000000000000000010000000000110010001010000100100010010001000010001000000000101000000100001000001000
01100000000110100000000000100000000000000010000000000000101010010011000000011000100000000101100000000
01000010000000001101011110001000000111010100001000001000010001000001010000000000001100100000010100000
00000000010000000010000000010000000000100000010000000000100001000000101001000000010100000000001000000
00001000000000001000010000000000100001010100110100001001000000100001000001010001001001000000000001100
00000010000000000000010000001100000010010000000001100100001000000010000010000000000100000001000010000
01001101000000100011000000101000000000100000010000000000000000000000001101000100000000000011100000001
00000000010000000011010000000000000000001000100100000000000010000000001100000100000001000010000000000
10100000000111110000000000011100001000000000000101000000100000010010001001001100000000000100100001001
00000001000000100010100000001100000000100010000010000000000001011000000100100000100000000000000000000
00100001001001000011010000000110000000000000000000000010000000000000100100001000000000000000010001010
10011001001011001010001001100000110000000000000000000000000101000000000100011000000010000000000010000
00001000010010000010010101101000000001000000010000000000000000000000000000010010010001100101110000000
01000001101101010000000010010100010100001000000000000000000101000001000000000000100000010010000001100
01010100000100000010000100000000000000010101000000001100000000000010000000010000000000100000000000000
10000001000001000100000001101000001100000000000000100010010000000011010010000110101000001000000100001
11000001000000001000100000010000010000110000000100000000000000000000000001000110000100010001000000000
00000000010011001010000000000000100001000000000000000010110010000000110101011001000100000010001000101
00100000100001100000010100000001001000000010000000000010000101100001011000010010000000000000001100000
10000000000000000000000001000010101011000100100000000000000000001001100010000000010100010000101111000
00000111001100000000000010000000000011000000000000101010101110000000000000000000100000010000010010000
00100000000100100010000010000000010000100000010000010000010000000000000010000000000010010001100000000
00000000100000000000000000100000010011010000001000000000010000000110000000000010100000000100001000001
00010101100001000001100000000010100000000000100100000001000000100001000000000000000000011000000000010
01011100000011010010000010100000010000000011011000010010000000010100000011010000000000000000000000011
00100001001000010000000000010000000000001111000000000001000000000000010000100000001100010100000001000
11010100000000000000000010000000000000000000000000000000011000000000111000000100000100000001000000010
00100011000000010000011000000000000000101000100110011000000000000000010101000000100000010100100000000
00010000101100000000000010000000000100000001001100000110010000100011000010000000000001010000101000000
11000000010000100000010000000010000000000100010000100010001000110000000010001001000011000100001000000
00010001000000000000000000010010101000000100100100010010101011101000011000100000100000000000000100000
11001000000100000000100100000000000010011000000001000000000000100000001000000000100000111001000000111
10000010100000100001000100001010000011000100001001100111000000011000100010000010001001000110000000101
00000000010001000100000001000000000011000000010010010001000000000000010000101000011010000000100001000
01010000000010000000010000010101011001100000000000000000000000001100000100101010100000000000010000010
11000101110100000000001011000000001000000000000100001000001000100001000000000000000000000000001011100
00000000000000000000000000000000010000000001100110000000000100000000000010000000001000010000101001100
01100000010100101000001000000000000000010001100011001000000100100000100010000010010100000000000000000
00000001010100000000010000001000101010000011000100000000000000100000010000000001000001001010110010000
00000000000100000100000000000000101000000001100001001001010000000000100000000001000000000010010001000
01000000001000000000000110000010000001100100010000010010001000100100001000000000010000100010000000000
10100010001000000001100000000000100001100000000010010100000000000100100000000001100000000000000000000
10000000000000001000011000001000001000001000000000000111010000001000000001000000000000000000011000000
00010000000000010000011000101000000001000000000100001000000001000000000010000000000000101001010010000
11000000100000000010000000000010000000100011000000000000000100000000000010001010110000000001000010000
01000000000010000000110011000000000010000000010000100000001001000010000000001000000001110000010000000
00000010000110000010000000100000000000100001000011000001010100000010000000000001000010000000000010000
10000000010000000000000010000011000000000001110000000000000000100000010000000100010000000001000100000
10100100110000000000011000000100000110000000010101100000000000100000101000011001000001010000010001010
00000010000000000010100000000001000001010000000000110001000100111000000100000000000001000000010000000
00000000001000010000010000000001000000000010001100000000010100000010100000000001000000000000010110000
00110011000000000000010010001000100100001100011100000000000000010000110001100000100010000001000001100
10000000001010011000000010010010010100001001001000000000001001001100101001000000100000000000001000110
00000100000000010001011100011010100001010000100001000000001000001000000011010001000001000000000010000
00000001000001000000000010000000001000001010000000000100000000000000000000000010000010100000111000000
00001101010100100001000000101001001001000000000010010010000000100000000000000000100001000000000001010
00000000000011000000001000000010010001101100000000000000000000000010010000000000000000000010000000000
00000000000001000000000011100000000000110000000000000010000010110100000100100000010001100000000000000
00000001000001010100100100000000100010000100000001000000010000100000000100000001000011000010010000001
00000100100001001000000100100000010000000000100000000000000010000000100100001010000000010001000001110
00101010010000001000100101010000001010000100000000010000010000101000010001000000000000101001000000001
00000000000001010100000011000000011000010000100010000100000010000010110101000011000010100000000000000
10111010000000001001000100010000000100001000000000000000100000010100000000100000000000000000101000000
00110000101010000000000001000000000000000000100001010001011001000000010000000100000000011000010011010
01000000000000000000000000000010010000000000000000100100010010000000001000010000000000000000000100001
00000110100110110000000001010000000100000110100000000000001010010010000010001000000000000010000000001
00000000111001000001110010000100000010000000000101000100000101010000000000000000000010000000000001000
10000000000001010000010000010010000100000010010100000100001010010000010100000011000010100010100000101
00100000000010000000000000000100010000000001001000110000100000000000000000101001100000100000000100000
01100000100100001000001001010000000000000011000000100000000000000101100010000000000001010000000000000
00100100011000110000000100000110000000000000010000100000000010001011000000100110000100000101011101000
00000001000000000010000000000011000000010000000100100010010000000000000000010100000010010000100000000
01010001000000000000000100000000100000000000000000010010100000100000000000110100010000010010010000001
11101000000000001000100101011010100100000010000100100000000110010001000001000000000000000000000000000
01001000000000100000000000000001000100000101001000010000000000010011010000001000001000001000110001000
00010000010000000000000110000000001010100000001001000000010000000000000001000000000000100000000000001
01000001100000100000000000000101000010000000100010000001000000000000011110000100101001110000011000010
10001001000001000000000000000000000001000000100000000000000001011101100000010001000010100100001000010
00000000000000001000000000000010000000110000010100011000000010001000000000010000010000000111000100000
00000010000001000000000000010100000100000000000000000010001000110010000000010000000000010100000100000
01100011000100000110000000000000000010001001001010101001000000000100001000000000000000100010001000000
