00000000000000000000000000000000101000000101000000000000000000000000000000000001010001000011000100000
11111100101110010101111011101110110011010011110101001111111010111010111000101111011011110111011111011
00000000101000000000001000000000000001000000000000000000010000000000000000000000000010000010000100001
10111101111101110111101101010111111110110111001101100001101110001110111011111010110101101101110111101
00000000100000000100000100000000000000000000000000000000000000000010010000000010100000000000010000000
01111101111110111010010011111101001101101111001110111101111111011101011111011010110100111111011101101
00000001000000000000000010000000000000001000000010001000001000001000000100010010000000000010000000000
11010110111011101110110110101111011111101011111011011110111011001011001101100111111111011100011110011
00000000000010001000010000000001000000001000000000010000100001000000000000000000000000000000001000000
10110111100101110111010110111010110010101110101011111110110111110000101010100110111111101101011010111
10010000000000010100000000000000000000000010100000001000000100000000000000000000000000000001010000000
11111001110110101101110110100111111011111111101000011111011101010110111101101100111110101111110010011
00000001000000100000010000000000000001000000000000001000000000010000000001001000000000001000000000000
11100111110011011111011001111110011111011100111011111110001011101011010100111111110101010111111111010
00000000000001000000000000100000001000010000001000000000000000000000000100000001000101000000010000000
10111100111110001111100011111111001011011111111001011111001111100111010011101001011011110000011111011
00100000000100000000000000000000000000001000000000010000000000000000000000000001001010000000000000000
11011101101101001011111001011101111101010011011101110111100001110011111111011101111101001110111000011
00000000000000000000100000000000000000000010000001000010000000000000000010010001000000000000000000000
11101110111110100110110111110101100110111011111101110011010010101010011011111101010111110110011110100
00001000100000100000000000000000000000010000000000000000000000000000000000100001000000000000000000000
11011011111111101000111011111010111111101010100111010111111011010100111011011111011011011110111101110
00000000100000000000001001000010010000000000000001010000100000000000000001000010000001000000001001000
01100111001101011111110110010101111111011111010110101001011011111010001101111110110110111011010111110
00000000000000000000000000000100000100000000000000000000000001000000000000000100000000000010000000000
01111010111001111010110000111111010111110110111010111101101100011110011101011011111001111110101111011
00100000000000000010100000000000000000010100000010000000001000000000000000000000001000000010000000000
10111110101010111111101100011111010011101011101111001101111111010111110001111011001011111101101110101
00100000001010000000000000010000010000000000000010000000001000000100000000000001000000000000001000000
11110010011001111111000111111111010101100001111001110101110011111011110111001001011011001110111100011
00000000000000001000000000100000000000000000000000000100000000010000000000000000000000000000000000000
10111101101010101011111111010101101001101111101110111011110111010011110111011011101100110101111101110
00010000000000000000100000000101001000000000000010100000000100000000000100000010000000000000010000100
01111110110010101101110111101100110110101110110111101111100011011111100010111111011110001010111111011
00000000000000000000100000000000000000100100000001000000000000001000000000000000000000001000000100000
00110101110011111110100111101010110111011100011111000110010101111010011101001111110011111111000111110
00000000000000000010000000000000000000000000000000000000000000000000000000000000010000001000000000010
11010111011110111111010111110111100100001111110010110110111111111100110110101101110111011110110111101
00010100001000001000000010000000000000000000010000000000000010000000100000000000100001000000000010000
01110101110111011101101110100011111111101011111111010101110100010101101110011111010111101110101101110
00000000000010000100000010000000000000100000000000000000000000010100000000000001000000000100000000000
10110110101100110111101111111011011001101010101111111110010111001111011100100110111100010111111011100
10010010000000000000000001000000000000000010000001000000000000000000000000000000100000000000000000000
11110111110000111100111010111100011101110111111000110001111111110111011011110011111011100111111100111
00000100000000000000000000000000000000100000000000010000000000100100001000000000000010000000010000000
10111111110000111100100111011111111011111100100111111100111111011101101001011001110110110111111101011
00100000000000010000000000000001000010000000000000100000000100001000000000000000000000000001000001000
00100110110111111010110011111111001110101011111011111110101100010111101111101010110101001101101111011
00000000000000000000010000000000000100000000010010000000000000000010000000000000000001000000000000000
01110101111101111111100101111101101011100011111101101111010111110101110101110101010110011111111011101
00100100001000010000000100100000001010000000000000100100000010000101000000100000000000000000100000000
10111110111001001110110111010111110011111001011110011010011101101110101111111010011111101010100110111
00000000100000000000000001000000000000000000000000010000000000000010000000010000000000000000000000001
11110110111001010101011111101011101010110110111101011111110111010101011101111100001010111101111010101
00000000000001010000000000000000000000000100001000000001000000000000000000000000001000000000000000100
10111011110011110100111101110001001111111111010001111000110011011110110011011011011111011011111101100
00100010000000000000000000000000000001000000000000000000000000000000100000000000000010010000000000000
01101111101011010010001111111011111110110011111011011010011111110111111010101101011000111111111010101
01000100000000000000000000001000010000000000100000000010000000100010000000100000000000000001000000000
11100111110101010100010011111111001111101000111011110000111111011101111100011111011111100110101110100
00000000000001010100000000000000000000000000000000100000000000000100100000000010000000000000000000000
10111011011111010011101011110101110110101110111111010101101110101011011001111001011111110110110011101
00100001000000000001000000000100000010000000001000000100100010000000000000000000000000000000000010000
01010111111101100001110011110101011101111010101100101111111101101101000001110111101101111101001101110
00000000000000000000000000000000000001000000000000000010000000000000000000000000000100000000000101000
11001111111001110111101100101110111111000111101011111110111011010110110111110100101111101111011011101
00000000100000000000000000000000100000000010000000010000000000000100000001000000000000100000001000000
11011101110100111011110101110101111111011001110111101110111101111011011000011011100111001111011101101
00000100000000000000100000000000001000001000000000000000100000000000000000000000000000000100000000100
01000010011111110110101101111101111101011101111110011011110101100100011101011111010100111111111101110
00000000000000000000000000000001000001000000000000000000000000000000001000000010010000000000100000000
10110111111110101010101110101010111111101010111011101111101111011011110011111010111110101111011110001
00100001000000000000000000001000000000000010000000100000100100000000100000000010010000000100000000000
01110101001111011101100111110111111100100111011110111101010111001111111011100010111111010001101111110
00000000000000000100100000010000000000000010000100000100000000000000000000000010000000000000000010000
01111110110110111110110110111110001110111111101001011111010111011100110001111100100111101110110111011
00010000100100010000100010000100000000000010000000000001010000000000000000000000000000000100000010000
01101101101111110110111011111101011110110010111101111101011111011001111111111001100101011111110000111
01000000000010000000010000100000001000010000000000000100000001000000000100000000000101010000000000001
01111010101111100110101110101101111001101101110100110100011111110111111100111110011010111110010111111
00001010000000000000000100000000000000001000100000000000000000000001000000001000000000000100000000001
01110111101111011010101111101101101111011011111001110111110100001110111101111010101101110111011111001
00000000100100010010100000000100100010000000000000000000000000000100000100000010100100010000000000000
10101101111011011001101011111011100111101101101101101100111110000101100001010011101011111110111011110
00101000000000000000001000100000000010001001001001001000000000000000000000000000000000000000000000010
11011011011101000101011111111010100111111101011100111010111110101111001101010111011110110101101101111
00000000001000000000000000000000100000000001000100000000000000000000000000010100000000000001000100000
10010011101111101011101100110111110000110111110010111110000111111011111011100110111101111100100111110
00000000000000000000000000010000000000000000010000000000000000000000100000000000010001000000000000000
01011011111010111111011100111011101111011111011011111001001111110011001001011011011110111010011110110
01000000000010001000000000100000000100001000001000000000000000000010000000000000000000000000000000100
11010011111110111011011110110000111111111101011100011100110001111101011101110000110110111100011111110
10000000000100000010000000100000000000000000000000000000000000000001010000000000000000000100000000010
01101100011101110010110111011111001111110010111010101101111101010111111001010111110000101111011101111
00000000000000000000000000000100000000000000100000000000000000010000000001000000100000000000000000000
01111010110011111110101011101111010110111111110110101011011101101111111010110011111101111011110111110
01000000100000000100000000000010000000000100000000000001000000000010000010100000001000001010000100000
11100111110101010101001111111110101111011000110110111111110100111101011101110100110101101110111010110
10000000100100000000000000000010101000010000000000000001000000000000000000000000000001000000000000100
01101111110110101101011011010110111111100110011011110011101011110101011111101011110111100011001000111
00100100000100101000000000000000010000000000001010000000001000010000000000000000000000000000000000000
