00000000000000000000000000000000000000000000110010010000000000000100000010000000000000000010000000000
01111110101010011111011110110111010111101110111111110001111100100111101110110101111010101111111010001
00100000000010000000000100000010010010000010001000000000010000000000000000000001000000000000000000001
10110111101101010100010111101110111011101011110011011010000100111111111011110101111101111110110110110
00000000101001010000000000000000000000000000000010001000000000000000000000010000000100100000100010010
11011111011110011111001011111111000110010111010111100110111110111110111001111101010011101111100100110
00010000010000000100000000000000000000000010000001000000000100000000000001000000000000000000000000000
11111010111110101111010111111111001100111111011101111010110011110011111011110111100011110011001111001
00000000100000100010000000010000001000000001000000000000000000000010000010000000000000000000000000000
01111110011011101110011111110011001110101101101111101100011111111101110101101111011110110110011011110
00001000000000000100000000000000001000101001000001001000000000010000000100000010000000000000000001000
10111101110011111011011010111101111011111000100011100011111100111100110111101011101110111100111010110
00100001000000100000000000100000000000000000000000000000010000000000000010000000001000000000100010100
11110011011110111111101011011011110110111010111011011011001011100011110011011100101101011111101110111
10000001000010000100000010000000000100010010000000000000000000000000000000000100000000000000100010000
01011111011100111111111101011011101111001010111011110111010111101110100111010111011101001011101101101
00000000001000000010000000010000000000000000100000100000000001000000100000000000000000000000000000100
01001100111001111111101111101011010011101110111011101110111011011101101111111001011011110101111100111
00000000000000000001001000000000000000100010100000001000000001000100000000100000000000100100100000000
11111010111101011111111011001110111011101101011110101100111111011011111101011001111101111100111101010
00000000100000000100000000001000001000100101000000000000001000001000100000000000100001000000000000000
00111011011111011010110111010110111110001011011111110011101110111111111010111101110011010110010011111
00000000000000000000100000000010001000000000000000100000000010000010000010100000000000000000000000001
11111001100101010111111110110111111001111100110110110110110111110111100111001111100011111010101111001
00000000000000000000100000000100000001000000000000000000100000100000000000000100000000000000001000000
01011011011110110110011111101011011110001111110011111111110011001101101111011011010010100111110111110
01001000000000000100000000001001000000000001000000100000000000001001000000010000000000000000000000000
11011101111101100111010010111111111110110110011101010100101001101111010101001111111010011111011101110
10001000001000100000000000000001000000000000000000000000000000000000000101000000010010000001001000000
01011111110001011111010101110011011011101010111101011010101110101110110011011111011110011001101111110
01010000000000010000000000000010000000000000010000000000000000100100010000000000000000000000000100000
10110100110111110001111010101101101111101011111110010010011011110111100011011110110010111100011011111
00100000000000000000000000000100000001001010000000000010000000000000000000000000000000001000000000000
01111010110111011111100011011101110010011011001111011011011111010111011010101000111011111111101010111
01000000000100000000000010000000000000000000000001000000000100000001000000000000000000000100000010000
01110101111011101011101011010110100110111111111101010110111101101111010010111101110101100111111011101
00010000000000000000001001010000000000000001000000010010010000000100000000000100010101000000100000000
10010101101111110010101110101111111100110011011111010000111011110101111100110110110101101111101100110
00000000000000100000000000000000000000000000010000000000000000000001000000100100010100101000000000000
11011101011101110110001101111100111001100111111101101000101110110101111110000101111011010111110110111
10010000000101000000000000001000000000000000000000000000000000000000000000000000010010010001000010000
11011101111110101011101110111110011101011111101001101001111111001011101011111101111101110011100000111
00000100000000000001000100100000000000001000000000000000001000000000100000001000000000000000000000000
11111011110011111100100001001110111101111011101101100011110111011001101101111001111001111101100011111
10000000000000000000000000000000001000001001000000000000000001010000000000001000000000001001000000000
01101111111011101110111111101111001011110100000111110011110110101110111110011110110101111110111101110
00100000100001000100000000000000000000000000000010000001000100100010001000000000000100001000010000010
01100111110101101011111001011101101101011101110101111010101100011100101011101111111101110111010111101
01000000000001001000000000000101001001000000010000001000000000000000000000000000000000100001010010000
00010111011101011011101011001111011110100110101111111011010010111111010010101011111110010101111110010
00000000000000000000000000000001001000000000000001000000000000000000000000100000000000010101000000010
10010111111110100110101100111111110011011101110111011001011011111011110110010111111111000110110010111
10000000000000100000000000000001000000000000010000001000000000001000100000000000000000000000000010000
01110111100101110101100011111011001101101111010111011111001111011011101011101001010111111100011111101
01000010000000000000000000001001000000000000000000010000000100001010000001000000000000000000000001000
01111010101110001110111010111101111101111011111100011011101111010111110011101010011110110111110111010
00100010101000000000001000000000010000010000000000000001000000010000000000000000000000010000000000000
11001111111000111110011010111101111101010111011111110111101110101111101111011010111101011101111111001
00000001000000000000000010000000100000010000000100000100000000100010000100000000010000001000010000000
10101111010110111010111011111111010101110110111010111010101010111111001000101101110111110100111011011
00000000010100000010000000010000000000100000000000000000000000000000000000000000000010000000000001001
00111111110110100110111111010111101110110101111011101101101011111011010010101011011111011100101010111
00000000000000000010000010000000000000100000010001000000000000100000000000000000000010000000000000000
10000111110111011111001111101111110010101110111101011111110001101010111111101111110111001101001011110
00000000000000001000000001000000000010000000000001000000000001001000000001000010000000000000000000000
10111110011010111010101010111111110101110111001111111011110111001100111011111101101011101100111101110
00001000000000001010100000000010000001000100000001000000000000000000100000100000000001000000000000010
11010110111011101101101111111110011101010110011011011010101111111010001111101001111111110110101001110
00000010100000001000100001000000000000000000000000000000001000000000000100001000000000000000000001000
01101011110101100101111111101011010111111110110110111110011110101011101000011110100111010011111110011
00000000000100000000000001001001000000100000100010000000000000000010000000000000000000000000000000000
10101001011001111011111000111110110111010111100111100111110101111000110111111111001011100111011011110
00000000000000000000000000000010010010000000000001000000000101000000000000100000001000000000000000000
10110010110011111011110111010111011011010101111001111011101011011111011110111001111000011111111011011
00000000000000001001000010000001010001010000000000000000001001000000010000000001000000000001000001000
11101011110001111011011110011110111011111011100110110001110110110111101011111000111101111101101001010
00001010000000001010010000000010001000000000000000000000000000010000000000000000010000000000000000010
11010111011101111011010101110111111110101110000111011011101011110111101011011111010110101011101111010
00000010000100000010000000000010000000000000000010000000000000100000001010000000000000101000000100010
11101011110001111011100111110011001001111110101101011101110010110101111100011111011111010111110001110
00001000100000000000000000000000000000000000101001010000100000000000000100000000000000000100000000000
00010001001101001111101111110111111101110111111011110011011111010111101100111101111010011001111111101
00000000000000000000000000000000001000100000100000000001000010010000001000000000010000000000000010000
10101001111110101101110110100110100110101011010111111101101110100101101110111111111010111011110101111
00101000000000101000000000100000000000000000000000000000100100100000000000000100000000100000100000000
10001111111001110111000110110101011111101110001101010011101101011001111101100110111111010111110011010
00000000000000000000000010100101000000000000000000000000000001010000001000000000000000000100000000000
11100101110110111001011110110101011010011101101110110111011101111111000011111011010111101111011010101
00000000000100000000000000100000000000000000000010100000000001000000000001000000010010001000000000100
11010111111000111001111110111101101111101101111011111111001010110001110111110111110101111100111110011
10010100000000010000000100001000100000000101000010000000000000000000100000100000000001000000100000000
11100110110101111100101011011111011111011001010011011101111101101101011110111101011111101010110101111
00000000000100001000000000000001001000000000000000000000100000001001010000100000000100000010100000000
11101011010110010111111101110100110110111110111101100011110101110010110111101010101111101101101110111
00000010000000000000010000010100000000000000100000000000000000000000000001000000000000000101000010000
11011011111110001111011111011101000110000001011111110101111100111101111110001111101010011001111110011
00000000100000000000000000000000000000000000000000100000000000100001000000000100000010000000000000000
11110011111000110011110101110111111111111000000011110011011100111011110110111011101010011111111001101
00000001000000000000000000000010000000000000000000100000000000000000000000100010001000000000000000000
11010111100010001110111011101110111110000101111011111111110001110110000100111111101011100111110111011
00000000000000000000000000100000000000000000000010000000000000000000000000000100000010000000100001000
