00000000000000000000000000001000000000000000000000000000100000000000000000010000100000000010000100100
10111110011110111011110010111111101010111101010111110010111001100111111111011000101111011001111101101
00000100000010100001000000000000000000100001010100000000000000000000100000000000000100001000000000001
01110111001101111011100111001011111001010111111010111111011001110111101111011000011110011101010111010
00010100000000000000000100000000001000000000000000000100010000000000000000000000000000000000000000000
11011111001110101111101101111001101111111101111000100010100111111110101101110111100101001111110111110
10001000000010100001000000010000000000000000000000000010100000010000100000010010000000000000010000000
11011110101100111000111110110101110111101100001101111011111111101001010010111011011101110011101011111
10000100100100000000000000000000000000000000000000010000000000000000000010100010000001000000100000001
01111111110011101001111111010101111111011111001011101010011011100011111001111011111101010101111011110
00000100000000000000100000000100000100001000000000000000000000100000000000000001000000010100100000100
11011110111101011111011110011101011110110010111010101101110101100111111110011101001011011110101101101
00000100000100000000010000000001000000000000000000000000100000000000100000000000000000000100100101000
11111100111011100111110011110011110110101010000010111011111111111111011101101011110111011111101101010
10000000100000000001000000000000100000000000000000000000000000010000010000000001000001001000001001010
11010101111011110100010110111100101011110111111101011011011001110100101111101111101011101111011100010
00000000000000000000000000000000100000010010000000000000000001000000000000100010000000000000000000010
10111011001110011101100001010011101011111111011101110101100111110110011110111011110101101000111101011
10000000000000000100000000000000000000000000000000010100000000000000001000000001000000000000000000000
11101110111000111111001111101110001100111011111000011011111001111101111101001011110011000111110111101
00001000000000000100000000000000000000000010000000000000000000010001000000000000000001000000000001000
10101110110111011001111101011001111101001111011111001011101111100101111111000001010011110011101111110
00000000010001000000000000000000000000000010000000000000001000000000000000000000000000000000000100000
01001100111111011101111101101101111001111111101111110101110011111111011001110111110101101010101111110
01000000000000000100010001001000001000000010000010000000000000100000000001000001000100101000000000100
01101010011111011010111111001110011011111101001110011111010001111001011111101111110110111110010111101
00100000000000000000001000000000001000010000000000000001010000000000000000100100000100100000010010000
10110101101111010101111101011111001111011011001111110010100011010110111111111010110000111001011110111
00010000000000000000001000000000001000000000000000000000000001010000001000000000000000010000000000000
01101111010110011111101101001010011101011011111110111010101111101011011011011110011111011101110110110
00000010010000000001001000000000000000000000000010000000000010000001010000000100000000001000010010010
01101111101110100110110111110010011110111111101110010011111011110111111101010111110111010101101101101
00000010000000000000000001000000000000001000000000000000100000100000100000000001000000000000001000000
10110111011100111101110101001101101101111001011111101011011100111011101111100111001001111111110011110
00000000001000000000000000000000100000000000000010001010000000001010000000000100000000000001000000010
10100011110011110111100111110010001011111111110101110010110111111111100100010011110110111110111110110
00100000000000000000000000100000000000000000000000100000000000001000000000000000000000000010000000100
01011111100010111101100111011110111011001110111111100110110001111110110111101101010101111111110110110
00000000000000000001000000000100000000000000010000000000100000000010000000000100000000000010000100010
10100011010011101111011110110110011101110110101111101111011011011011110110110111101111110000101111110
00000000000000000000000000100000000000000100100001000010010000000001000000000100000000000000100001000
11011110110011011101011111100111101010110110010100101100111111011111100110111110100111111011011110011
00000000100000000000000100000000001000000000000000000000000000000010000000000100000000001000000000000
11010011011101111101110111101000111101110111101010111110011111110101001111011111001110111011101010110
10000000000000010000010010001000000000000000001000000010000000000000000001001000000100000000000010010
01111001110111111111011001111111000011101110110011111101011011110101110110111011111000011111111101110
00100000010000010000000000100000000000100000010000000001010000000001000010000000010000000000010001000
10101111011111101010011111010101100011101110101110011101111111101100110011111001111111011110010101111
00000010000010000000000000000000000000000010100100000000001000001000000000000000010000000000000100001
11101011011101111010110111001000111101110011011011111111100110011111111101011001001100101111111001111
00001000000100000000000010000000000000000000000000000000000000010000000000000000000000100000100000001
10000111111110111101011110110101001111111010111011101010101011101110010111111101110000111101111110101
00000000000100010001000100100100000000000000010010000000000000000100000000000000000000010000010000000
11101101011100111010001111111110101010101101111110001111000101010111111111011110111111110111000101011
00001000000000001010000000000000101010000000000000000010000000000000000001000100000100000000000000000
01101101110101101111100110101011111101111011101011110111111011010111011110100110111110110011101110110
01000000100000000000000010000000000100000010000000010000100000000000000000000100000000000010000000000
00111101110111111110000011111111001011011010111101010110110110110110110100011100111111101110010101111
00000000000100000000000000100000000000000010000000000010000000000010000000000000000000000000010000000
10111101101110111100011011110110111110101101100011010110101111111011101111101011101111011111011101000
00000101000000010000000000010000000000000001000000000000000000010000000100000000100000000000000000000
11101001111010110101111101101110110111001101101011111010111100101011011111001111111001111001010110110
00000000000000010000000100000000010000000000000000100000010000000000000000000010000000000000000100100
01011101011101001011110011111001111101111101011100111101010111011111011011110000111100101111111111100
00000000000000000000000000000000010001000001010000000000000001000001010000010000000000000000000000000
10111011101110111001111011110010001110111101111110101101011011101101111101011110111101110101011110110
10000000000000000000000000000000001000001000100000000000000010000000010000000010000000100101000010100
10111101111101000101111111110010001011111101011101010111011101101100111111111100100111110110111101110
00000100000000000000000100000000000000000001001000000000000000100000000001000000000000100010000000000
11001111011001011001011111110010101111100100010100111111101110100111111101110110111111001011111011101
10000000000000000000000000000000000000000000000000000001000000100000001000100010010000000000100000000
01111100010111111110101101101111010111111011100111101101101101011111110011011011111110011101100101110
00000000000000010000100100000001000000010001000000000001001000000000000010000000100000000000000000000
11100100110111111110101011011101011110101101011111111011110011100010111110011110101111111010100111011
10000000000000010000000000000101001000100101000010000010000000000000000000000000100000000000000010000
01100111111110011011100110111010101111110011101111001011101101101010110101111010111001101110010111101
00100000001000000000100000000000000000000000000000000010000100000000000000001010000000000000000000000
10111100110111101011011101110110111111010011011110011001111111011110010111011110111010111011110011101
10000000000000000001000000000010000000000001000010000000000001000000000001000100100010100000000010000
11111110111100100100110110110111010110111110111101101111101011011011111101011100101111000110011101110
10000000000000000000000010010100010000000010000000000100000010001000000000000000000000000000000000100
11001001011101111101111100101111111101101010110110110001001111100010101101011111111100111010111001111
00000000000000000100010000000000100000100000000000000000000000000000000000000000000000000010001000000
01111001110111011011011011111010101101111110101111101001011011101111110001101101111001101101010001110
00100000000001010001000000001010000000000000100100000000000000000000000000000000000000000000000000000
11011111010111011111011100110011101111110111011010101111111100101111001100101111111011110011010111101
00000100000001000000000000000010000010000000010000000001000000000000000000000001000010000001010000001
10111001110101001110111110011011001111101011100111001111111001101011101011110100011001011111011111010
00000000000000000000000000001010000000000010000000000010000001000000000000100000000000000000000000010
11011111101001111000110111101011101111000111011111101011011001111010101110101100110111111011011011110
00000000000000000000000100000000000000000100000100001000000000001000000000000000000000000010010000100
01111110101111010011111111101001001111111101101011111110111110011011111110100101110011001111111011011
00000100100000010000001000001000000000001000000000010000010000000001000000000000000001000000100001000
10111011110010111010110110011111001101111100101101010110101101111010111110101111011111100111011111010
00000000100000000000000000000000000000000000000000000100100100100010000010000001000000000010001000000
11011101111011011111110100011111011101110111110110100011111101111110011011010011111101111001101111101
10010000100010010000000000001000010000100100000100100000000000000000010000000000000100000000000001000
11101111100101010101011111011110011110100111000101111111101110100001111010100111011111111101100011011
00000000000000000000001000001000000000000000000000000000000000000000000000000010000010000000000001000
11010111111010110111111101011011101111011100011111100001111111010111110110101101011011011111011001101
00000000100000010001000000000010001000010000000001000000000000000010000010101001000000000100000000000
