00000000000000001000000001010100000000000000000001100010000100000001000001000000100011000000100000000
11011011101011011110110110110110110101101011111010101101111101110111101000111101101111011110110111101
00000000100000000010010100000000000100000000000000100000001000000100000000000100000010001000100000000
01011011100011101101111011110111111011001011100100111110111101101101101101110111110001101011111010101
00000000000000000000001000000001000000000000000000000000100000000100000000000000000000001000000000000
11101111001001110111110001111010111101101111010110011010101011101111110111110110110001011011011011111
00000000000000100000100000000000000101000000000000000010000000000010000100000100100000000000000000001
11110101011011010101111010111111100100101111101101011111001110111000000101000110111111100010011111011
00000000000010000000001010000000000000000000000000000000000000000000000101000000000000000000000000000
11110011011011010111101101001011101101010110111011101001101110110111010111101011110100111111110101110
00000000001010000000000000000000000000000000000000000001000000000100000000000001000000000010000000000
00111110101110011111111010111001001111101011111101100111111010011101011101110111110111111010011011111
00000000000010000000100010010000000000000000001000100000001000000000000000010000000010000010000000000
10000011111011111011011111011010001111011111011101111101101011001111111011101011111100111110100011011
00000000000000001010001000001010000000000010000100100000000010000000010000101000000000100000000000000
10101010101111111001111110011101111000101001110110101111101011111101110101010011111111011101001110111
00100000000000100000000000000000000000000000100100000000100000001000000000000000000100000000000100000
11101101111010111111100111000111110101101110110111001111110110111101000111111011110010110101101011101
10000100000010000000000000000100000100000000000100000010000100100000000000100000000010000000000000000
10111111111011000011111010110111011101110011110100111110110110110110111110011110111100111001011101110
00000100000000000000000010000001000000000000000000010000000000100100010000000100000000000000000001000
01111000110001111111011011011110111110100010111101111001111010011010111011111011101101010110111011110
01000000000000000010010001001000010000000000000000100000000010000000000000000010000001000000000000010
10110100101101101011011110110111101011101101101101110110111001110111011010111111110101101101101110111
00000000000000000000000010000001000000101000100000010000000000000010010000000010000000100000000010000
11111100111011001001101101110011011011111110010101001101010111101011111011101111010100101110001111110
00000000000000000000000000000000010000000000000000000000000010000001000010000000000000000000000000000
11110110111111001100001101100111010010100111111111111100110111101111110101101111100100111101001011111
00000000000000000000000001000000000000000000000010000000000100000100000100100000000000000001000000000
10101101110110101101111110011010111101110111101101110111110100111011011110111100101011001101011101101
00000000000010101000000000010010000001000001000000010000000000010000000000000000000000001000000000100
11011111011011010110111111100111110100111101101111011111101111101110010110100111010110111101010000011
10001000000010010100001000000100000100000000000100000100000000000000000000000000000000000000000000000
11011101111110101111010110010111011001011011111010001110110110111110110111111101000011011111110110001
00010000010000001000000000000000000000000000000000000000000010001000000000000000000001000000000000000
10111010111011110111011011100101101010101111111010010111010110110011110110110111110111100101111111101
00000010100010000000000000000000000000100000000000010001010000000000010000000001000010000000000100000
11000111010101111011110111011111011011001111011111110001101010011101101011110111110001101111011011101
00000000000000000001000000010000010001000000000100000000000000000000000000010100000000000010000000000
01111101111101001111011011011111011011011011101110111001011110101111011011101100111100110101001110111
00000001000000000010001001000000001010000000001000000000000100100000000000000000010000000000000000000
11100111110111110101111110111100111011110111101001011111101010111110011101101111111101111011010111110
00000000100001000100001000100000010000000000000001000100000010000000000001000001000001000001000000010
01101100110101111011101110101110011111110111011110010110111011011110110011011001111001111011001011010
00000000000000000000000100000000000100000100000000000010001001001000000000000000000000000000000000000
11111101010010111100111011111001001011110110011101111100011110111111110011100111001111111011110111101
00000000000000010000000000000000000001000000000100000100000000000100000000000010000000010000100100000
10111101011110101011101011010011111111010111100111110111010101110110110111110101111011101110110111101
00010001000000000000101010000000000100000000100000010100000000000010010100000100001001000010000000100
10110101111010101111000010100111110111111101101001011001110110111011111100111110010011110101110111110
00000000000000000000000000000000000000100000000000000000000000000001000000100000000000100100100000000
11011110110100001111110111011010000010111111111111100111011111110010110111101110110010110101110111101
00001000000000000000000001010010000000000000000100000010000100000010000000100000000000000000000001000
01110010111101101101111010111001111111101011101101111000011010110010111101101010110101010101111110010
00000000000100101000010010000000001000000000000000000000000000000000000000000000000000000100000000010
10110111011011111001110101111110010111100111101011010101100101111111110111111011011011111010110110111
00010000000000000001000000100000010000000000000001010000000000000001000010000010001000000000000010000
11101111011101111001010011011111101011100110110110101111110101110111001110011011011001110011110111110
00000100000000000001010000000000000000000010100010100001000000000100000000000000000000000000100000100
11110111000111111001111010110111100101101011110111011010111111001111010001111110111011101001010101111
00000100000000000000000000100000000000000000010000000000000000001000010000000000010000000000000000000
11110111011101011010111110111010010101011001011111011011110100111101101111111010110101110101111110101
00000100010000000000000000000000000000010000000000000001000100000000000001000000000000000001000000001
11101101110111011101110111011000011111010110110111100111000111111001100010111111111110111101001011101
00001000010000001000000000000000000000000000010100000000000000010000000000000000010000100000000000000
10110011110110100111010010111111101111100110011111011100111101101110111111101011010101101101110111011
00010000000000000000000000000010000100000000000000010000000100100010001000000000000000000100000001000
10110111101011110011111110111010111111000111101100111111110111011101011101100101101101011101111110011
00010001000000100000001000000010001000000000000100000010000010001001000000000000000000000100010000000
10011001111110000111110101111110011111111010110101101111010100110111001111100111111111100001010110110
00000000000010000000000000000010000001000000000000000100000000000000000000000010000000000000000100100
10111001111101111101100010110100111110011011010110001011110111001111001011111110111110111110110101110
00000000010000000000000000000000000000000000000000000000000100000001000000000010000100000000100000010
00111111010111101101000110101101001101011011111101011111111101001011110110101101101111011011011111001
00000000000000000000000010000000000000000000000101000001000000000001000000000000001000000001000000000
01110110111101101010111101011110111110010111100111010111111101100111101101011111011011101011111100110
00000000001000000000000001000010000000000000000000010010000000000100000001000100001000000000000000000
11101101011101111001110111010011101011110111001111001111110011101110110111011010111110111101111111000
00000100000000000000000100000000000000010100000000000001000000000100100100000010000000010000000000000
10101111101011111011101101011111011110111101111000101101011011011101111011011111100111111011011011011
10100000100000010000101000000010000100000000000000001000000000000001000010000010000001000000001001000
10101111101011101101011100101111010110110111111001111011110101111010101011101111100101110011001110111
10100010001001000000000000000000000010000000000000100000100000010010000000000001000000000000000000000
01110101110011111101111110110111110001001110111011011101101110010111110111111100101001101101111110011
01000100100000000100010000000000000000000100100010000001000000000000010010000000000000000000010000001
11011100111011111110011011001101011101011101101011100111011110101110000110110111011110101011110010110
00010000000001000000000000000101000101000000000000000000000000000000000010010000000000000000000010010
11010001111111010111001010111101110100100111110101010111011101110000110111010110110010101110111111101
00000000000010000000000000000000000000000000000000000000000000000000000000010000000000000000000100000
01111100110110111010111100110001111111101111100111010111011011111101101111011011110111101101011111010
01000000000100100000000000010000000001000000000100000010010000100000101000010000100000001001000001010
11110101101110100110111111101110001110010100111111011110101001011110101011101101111111011010000111010
00000100000010100000000001000000000000000000000000000000000000000100101000101001000000000000000000000
10111100111101101011110111111100001001110110110110111110001101110111111101000101111100011001100111101
00000000000001000000010000000000000000000000000010000000000000010100000000000000000000000000000000100
11010111011100010111010101101011010111111111001010010111011101101110110101110111011011011101101110110
00000010010000000000000000000000000000000000000000000001000100000000000000100001001000000101001000000
11110110101001111111011011101011110111011111001101100111011110110111110101011011101110111101011001111
00000000001000000000010000100000010000000000000000000010000000000100000000000001000000100000010000000
01111101101111011001111111001011001011011101111110110011100011111101101100111100111110110111111111001
00000101000010000000000000000010000000000000010000000000100000000000000000001000000010000000010000000
