00000000000000000001000000001011000000000000001100010000000000100000000000001000000001000000000001000
11101101000111110101111111100100011110111011000111101110111001111010111111110010110110010101111001101
00000000000000010100000000000000001000000000000001001000000000100000001000000000000000000000000000000
10011011110100001111111011111011011011010111111010111111010111011011101111111001101110110110101010111
00000000000000000000000001000000001001000000000000010000000010010010000100000001000000000010101000000
01111110011111101101110111001111101000110101001110110011011110111101101010111111000111110111001111001
00010000000100000000000000000000000000000000001000100000000010000000000000000000000100000100000000000
10111111111010110110111110100011101011100111010110110000011111000111111011110110101101011111110101110
00000100000000100000000000000000000010000000000000010000000000000000000000000010000000000010000000000
10111110110011110110101101111111011010111101100101110110011101110110011111110010111100111011001101111
00000000000001000010100000001000001010010000000000000010000000000000000100000000000000010000000000000
01101000111101101111010111011111101010110011100101111001110010111110111111011101101100011101110111101
01000000000000000000010001010000000000100000000000000000000000000100001000001000100000000000000000100
11011110111001010101111100110101111010100001111111110101011101111111001011011011001011011111011111101
10000000100000000000000000000000010000000000000000000000001000000000000000000000000010000010000100000
10110110101101010111110111100100110000111101111111010111110011110111011101111110101011110110111111110
00000000000000000001000100000000000000000000000000000010000000000100000000100000000010000100000100000
10111011111010101010011101111110111111001100011001011111110111111101110101101111011111101111110001101
00000001000000000000000000010000000000000000001000000000010000100000100100100100000100000100000000000
11010111011100111011101101101111011011010011111011101101101001110110011111110101111100010001101101100
00000001001000000000100100100000010000000000000000000000000000000000010000000000000000000000000000000
01101101110110111011011111101001101011011011101011111100110110101110110110011011110101011100110111110
00000000010100010001000000000000000001001000101010000000100010000000000000000000000000000000010010000
10110111010111011111011001011011110011111010111011010110111110101110110110101111011011110101110111101
00000000000001001000000000000000100000000000000010000000000100101000100000000001000000010100000001000
01111011111010111011110010001110111111010110110111101101010110101100111111010110111000111100110111011
00001000000000100000000010000000000000010100000000001001010100000000000010010000000000000000000000000
01111101101011110011011101011011110111101100110011010101101101011001111001111011101101011110111011011
00000001000000000001000101010010000000000000000001010101000000000000001000000000000101000010000001000
01011101111011011110101111110101111001101101111011110011011101110111111010111001111110111000100011110
00000000001010010000100000100000000000100000000000000010000000010001000000000000000000000000000000100
10110110111110111101110011110111010101111111101001110010011101111011110101111010111011110011110110111
00000010000000010001000000000010000000000000000000000000001000100010000101000000100000000001000010000
11101000110110111110110111111001101011111011111101011111010101111011101111011110111011111011011010111
00000000000000000100000001000000100000010000100001000000010000001000000001000100000010000010000000000
10111010000100111111111011011101111010010111101110111111101001111000101111011111100011011101111101011
00000000000000000000001000000000000000010000000100000100000000000000000001010000000000010000010000001
10110011110010100011011110000111111111101110011111101101111100011110111010100110011110101011110111110
00100000010000000000000000000000000000000000001000001000001000000000000000000000000000000000000001000
01111000111111100010100111111100011111011111011000111001111011101111111010101011010011001101111101011
01000000000000000010000000000000000100010000000000010000001000100000000000000010000000000000000101000
10110101101111110010101110111011100010100001101011010111111111010110111101111010111001100110110111110
00000000000000000010100000000000000000000000000000000000000000010100000001000000000000000000010000000
11101111101011011101110110100101111111111110101000110011110101101111100110101111011111000111011100110
10000100000001000000000000000000010000000000000000000010000000000100000000000100000000000100000000000
10111101111101010110111101011101011011110111101111111110100010111101001101110111011011111011111111010
00100001000001010100001000000000000000100000101000000000000010001000000000000000001000010000010000000
11011011010111111001110111011110011101110000111111011110111110110111111010101101100110100110111101110
00000000000001000000100100000000000001000000000001000100001000000001000000000001000000000000000000010
11101110100111011101110011101101111010011111001100111011010011010110110111110110101111110001011011110
00000000000001010000000000100000000000000000000000000000000001000000000000000000101000000000001000000
01111111100100101101110110100111110111110110111001001111101011111111001011110000011111111100101101010
00000000000000001001000100000000000010000100001000000000000000000000001001000000000000000000000101010
11110111110100011011010011110110111111101000111011101010111101110111100100101111100010101110011111101
00000000000000000000000001000000000000000000100000000000001000000000000000000000000000000000000001000
01110001110101110101010011000101111111110111011010111100111001101011011011111000100101110011111110111
01000000000000000000000000000000000000010000000000000000000000000000000000000000000000100000000100000
01111011110011111111001111000111101011110101111101011101110100011101111011010110110101110000111111101
00000001000000001000000000000001000000000100100001000000100000000000000000000000000100000000000000000
10011010111101000110010111111111001110110101011111100101111011001001111010011011110101100111000111111
00000000000000000000000000000000000100000000000000000000100000000000000000000000010000000000000000000
11110110101110111011011100110111011011010010011110111010110111011101101110110111110110111111001111011
10000000001000010000000000000000000000000000000000010010100000000100000010010000100010001000000100000
01010011101010111110011110011001101110110111110111101101111011011011100001001010111111111111011011101
01000000000000000000000000001000000000000001000001000000100000001000000000000000000000000000010001000
01011101101111100101111100111101110110101111101110111011001101111011011101110001110101011110101011011
01001000100100000000001000000000000100100001001000000000000100000000010000000000010000000000000000000
10110111001111001101111011011101100110011011111010101011101111001111001110010110110011111110011011011
00000000000000000101000000000000000000001000000010000000000000000000000000000000100000000100000000000
10100110101011101101011101110010111101101011011111101111110101101000111010101011111111110000100111011
00000000000000000000000000000000001000000000000010000000000000000000010010000000000000000000000000000
10111111111010011010111101011111101010000111101011111010101111101101110111000111011101110101101011110
00001000000000000010000000000000000000000000101010000000001000001000010100000000000000010000000000010
11011011111101101011111110111110110100011001111010011110100110101111010101111011111011110000110111110
00001000001001001000001000000000000000000000100000000000000000000010010100001010000010000000000000000
11100111101011010111110101111001001111111100011111011010101101111000001011111101111001011111101110001
00000000100000000000100100000000000000000000010000000000101000000000000000000000010000000000000000000
11110111110011101110111110001001110011110101110110101011011010101011111000101111110110111110110111110
00000100000000000000000000000000000010000000000000000000000000001000100000000000100010000000100000000
01111011101110111010111011011000001101110111011101101011110011110101110111101001011010011011111111110
00001000000010000000000000000000000000000000000000001010000000100000000000000000000010000000000100000
11110111011001110011001111110110111111111011101110100111110111101110101110011101110010110110111101111
00000100000000010000000000010000000010000010000000000000100100000000101000000000000000000010000100000
11011110011100101101101111111001111100111101111001100011100011111100011101001110111101110110010110111
00000000000000100000000010000000000000100000000000000000000000000000000000000010100000000000000100000
01111111101100110101111100111101111001111111010110111100001111110111101111101011110111000110101010110
00000100000000010100000100000000010000000010000000000000000000000010000100000000000000000000000000100
01101111110001110101110111110011110101111110111111010011111101000011110110010101111111101110110111001
00000000000000000100000000100000010000000100100000000010000000000000000100000000000001001000000000001
11101111000101111110110111110111101001010110101101110111101111011011011101100111100101011101101111110
00000000000100100000100010000000000000000000100100000000100100000001001000000000100000000000000000000
11101111010011111101101111011110111101111010110001011110000111001110011101011101101011110111111011010
10001000000000100000000100001000000001000000000000000010000000000000000000000000000000000000010010010
00111011011101111100111100101011010111010111110111001011101110110111101111110011101001111011111010101
00000000000101000000000000000001000000000000100000000000000100000001000000000000000001000010000000000
10101011101011011011101111101111000111111011011111001000111111110011111110111010011011011110101011111
00000000000000001001000001000100000000001001000100000000000000000000100000000000010001000000100000000
10111111110011000011110101101001011001110001011111000111111110110101001101001011101011011111011011110
00000000000000000000000100101000000000000000000000000000000010100000000000000000000000000000001000010
11110110101100111101110111111001010111001011111101101111001110010111011101111011101111101110111101010
00000100100100000000010000000001010100000000010000001000000100000000000100000000001000001000000000000
