00000000000000010000000110000000000001000000000000100000000001000000000000000000010101000000000000000
01111101110110111101001101011111100100010110110011101111011011010110111110110011001101110111110011110
00000000100000000000000001001000000000000000000000000001001000000000000000000001000000000000000010000
11101100101111011110011011111001100111010111110010111011110111011111010011101001111100111110111001110
00000100000000000000001000000000000000000001000000000000100001010000000000000000010000001000000000000
11101011010111101110111100000110001111111011000101001111101111111110011111010110001111101101101111100
00000010000000001000000000000000000000000001000000000000000000010000000100000000000000000101000000000
11111001101110111110101110111111011100110010111111011101001100101110101010111110100111101110111101110
00000001001000010000000100001000000000100000000000000000000000000000100000000000000001000100010000000
11010011111110111011100111101011000101110011100011111111101111110111110100010101101101111101010101110
00010000001000000000000000000000000000000010000000000100000100000000000000000001001000000000000001000
11011001101111110101110011111011011110110111010110111101110001110111100111111111001111011101110110101
00000000000010000100000000000001000000000000010100100000000000010010000001000000001000010000100010100
10111101100011111111101111101100101010110111111011111001101110111011100010010010000111101111011111101
00100000100000000010000000000000000000100000100000100000000000000000000000000000000000000000000000000
10111010110101101111111001011111010101011010110110111011101101111100111011011101010101011100111011110
00100000000000100000100000000000000000001010010010000000100000000000000010000000000000000000000000000
10111101111011100101110010001111111100101111111110101010111011111100001011011011111111101001001100110
10010000010000000000010000000000000000000000100000000000000000000000000000010000000000000000000000010
10111110110010110111110110001111110111011000100001111111111100101111101101010111111111111010001111100
00001000000000000000100000000000100010010000000000000000000100000000000100000000001000000000000000000
10101111111101111101110111011010111011011110011100110011111010101110111101010101111111110011010011101
00100000100001000001000100000000010000000000000000100000010010100000001000000000001000000000000000000
11011011110001111110011011100011111101010000111011011101111111100101101100001111011111100100100111111
10010000000000000000000000000000100000010000000000000000000000000001000000000000000000000100000000000
11011011110110100011111101111001111100111011101110000001111111101110001101001111110111011011001111010
00000000100100000000000100001000000000000000000100000000000000000000000000000000000000000000000000000
11111010001101100111101111110001110000111110111110010110110011011111011111110100101100011010110101101
00000000000000000000000000000000000000001000001000000000000000000010010000000000000000000000000000000
01110110111110101110101101111010111000101011110110100010111101111101111100111110011100001101111101011
00000010100000000000001000000000010000000000000000000000000000000100100000000000010000000000000000000
11101100111101100011111100101111101011010010111111011111101110110111110010101110101111100110111010101
00000000000001000000000000000000000000010000000000000100001000100000000000000100100100000000010010100
11011011101101111011000101111101011111101011001111111101100111010111011101101101111011000110010111110
00001010000000000000000100000101001000000010000000100000000001010000000100000000000000000000000000000
11010110101100111101110110101011111110101101111110011111010101111000111011111010110101011110101101111
00010010101000000000100000000000010000000100000000001000010000000000000000010010010100000000000100000
11111101100101100111110111001000110100011111011110111001111111111100001111111100010110010110111111110
10000000000001000000000000000000000000000000000000100000001000000000001000000000000100000000000010000
01011110111001110111111001110101111101110101111100011101000111011101110101110110111101111101111010011
00000010000000000000100000010000001000100000000000000000000000000000000000000100001000001000000000001
10100010110111011110111101001111101110110101110111011101101110100000111111001111111100111011101111101
00000000000000000000000001000000000000000100000010000000000000000000000001000000100000010000100100000
11110110101011111100100011101101110101111111101101011111011111010110110110111111100101110110111011011
00000000000000000000000010000000000100000100001000000000010000000000100100001000000100000000001001000
11110111001111011110111101011011111010100111011101110001011100111010111011011101101011110101100111011
10000000000100010000100000001000000000000001000000100000000000000000000000000100000000000000000001000
01110011111001111111110110001000011110101101111111001101101110111101110110111101010111010111101011110
00000000010000000100000000000000000000000000000000001000100010000000100000000000010000000000101000000
01110111011110010110110111110001011010111010011010101111011101111101100100101011111100111110110110101
01000001001000000000000000000000000000001010000000000000000100001000000000000000000000000100000000000
11101010101011011101101010111010111110101000011001111110111111110110111110010100111101100111111001011
00000010101000000000000000001000000000000000000000000000000100000100000000000000000101000000000000000
11101000111101101001001001111111110101101001111110111111110001101010011101011100111011111111101000100
00000000000000001000000000000000000000100000000010000000000000000000000100000000000000000000000000000
11011011010100101101111101101010110111111110011011001101111101101111111101111011011101101011101110101
00000001010000000000000000000000000001000000000000000100000100000000100000100010010000000001000000100
00111011110111011011011101101100010101011101110110111101011101100111111111110100001110111110111111001
00000000010100000000000000000000000000000100000010100000001000100000001000000000000000001000010000000
10110100010111111110001111111001101101101101110011000101111111111101011110001100111111101101110110110
00000000000000000000000010000001000000000001000000000000000000100001000000000000000010001000000000000
01111010101011011110111010110111011011110001111110110111101011110101011111101011011100110101111001110
00000000000000000000100000010100001001000000000000010000101000100000000000001000000000000000000000010
11000011111110011100110001111101101011111011011001010101011111110110111100010111101110110110100110111
00000000000000000000000000000000100000000000010000000000000000000100000000000000000010100000000000000
10111011110101101101111100110011001101001111111011101111011011101010101110011111101011010101110111101
00000000100000000000001000000000000000000000000000000100000000001010100000000010000000000000010000000
00010111110101111011101111011011110111101010010111011110111011100011011101110110111101010011110111110
00000000000000000001000000001000000100001010000000000000001001000000000000000000010001000000000000010
01111101101111110110011101110101100101101111101101111111001111001111110001001011011001111110100111010
01000001000100000100000000010100000000000000001000100000000000000000000000000010000000000000000000000
10110111011110011111111000110111100111010000011100111100110111010111111011001101111110110101001011101
00000010010000000000000000000000000000000000000000000000000010000001000001000000000000000000000000100
10101110101101110111100101101111010101111001111111011101110111111101101001111001111111011001110010111
00000000000101000010000000000001010000000000000100001000000001000000000000100000001000000000000000001
01111110101010011111110111001111101011011111101001101111010110111101011110110110111111101011101011011
00001000000000000000100100000000001001000000000001000100000010001001000010100000000100000000101010000
11101010110110110111101111011011110111010111111011001010101101101111011101110000010110111110110111110
00000010000000000010000010001000100010010000000000000000000001000100000000000000000000000000000100000
01011110111101010110010111111011001110101111101111010111110100110001001111110000111011111011110110110
01000100000001010000000000000000000010000001000010010000000000000000000000000000000000000000100100100
10010110110111110001101110010111011101110101101110111011010111011100111011101111101101110010011111110
10000000000000000000000000000000000000010100100000000001000000000000001000000010000000000010000000000
10111011011110101111010111101101101100111101111100011101111111110101011011001101111011110000111100110
00100000001000000001010100000000100000000000000000000100000100000000000000000000000000000000100000010
01101111101101111100111101111011001111111111000100111101101011100110111111011011101011011110110101101
01000100000001000000100001000000000010000000000000010000100000000000000100000001000000000010100101000
11011011111011011100111110110011101111001111100110011110100010011011001111111101110111001101110110111
00010010000000010000000010010000000000000000000000000100000000000000000000000000100000000000000010000
11011110111011111101011011101011101100101111011011111111001100100110101011111101001101011010101011111
10001000001010000000010001000000000000000000010000100000000000000000000000000000000000000000100000000
10111010110100110101001010111111101111110111001110101101101101110110110101111011111110100010110011111
00001010000000000000000000000000000001000000000010100101000000000000000100100000000000000010000000001
11111001110011111110110110101010111011100101011101110101011111011110011011001111011101011011011111010
00000000000001000000000000000000100000000000000001000000000010010000000000000001000000000001000000000
10101101001101110011011101010011101101111011001101111010011101110111111011011111110111001111001011101
00000000000000000000000000000000000000001000000000000000000000100000100000000100000100000000000000000
01111011011111011110101100001011111011101111001110011111100111110110011110110011011111111010010111110
00000010001000010000000000000000000001000010000000000001000000010100000000010000000000000000000100000
10101110111010101101111011111010011101111101111011101111110110011110101101110101101010110100011111110
00000010000000000000010000000000000100001000010000100000100000000010101001000000000000000000000000000
