00000000000000000100000000010010000010000000000000000000000000000000000000000001000000000000000000000
00010111101011111001110111110101111011111101010111101101111011100111101100110101110001111011111101000
00000000000000000000000001000000001000010000000000000100001000000000000000000000000000000000000000000
11110100011111111011011110110101101110111011111110011100100110110110110110111100011011110101001111011
00000100000000000010001000100101000010010001000000000000000000010010010000000000000000000000000010000
10010101100101101111100111110101101111101110101100011101101110011110110100110100101110101110111001101
10000000000000000000000000000000000100000000000000000000000000000000000000000000100000000000000000000
10110101011111011011011101101101101111110001001110111110110101111001111111010010011101111101011111010
00100000000000000000010000000001000000000000000010010000100100100000000000000010000000000001001000000
10111110111000111110011101111110110100110101011111010111110010011011110011110011110011110101111011110
00000000000000010000001000001000000000000000000000010100000000000000000001000000000000000000100000000
10110111000111100111100110001101001111111010111111100101111011100111010110110111110110111110111100111
00100000000000000000000000000000000000000010010000000000100000100000000000000000000100000000100000000
10111011100001111110111101100101111101111001101101011110010110111100101110011011101101111001111010111
00010000000000000000100000100000000000000000001000000000000000000000100000000000101000100000001000000
10110001111101011101011000110011101111110110101111011000011111111111100110101111010110101101011110011
00000000000000000000010000000000000000000010000001000000000000001000000010100100000010101000000000000
01011111110110101111110100111110101110101011110101101111110101100110101110110111100111011110111101100
00000010000000001000000000100000000100000000000000000010000000000000000000100000000001010000000000000
01111011111010110011001011111000111111110011101111100011011110000011000111110110010111101011110111010
00100001000000000000000000000000000010000000000000000000000000000000000000000000000000000001000010010
11011000110110011111010110111101111110110011110110111011111011100110110010101111011010101111010111101
00000000000000000000010000000100000100000000000010100000000000000000000000001000000010000000000000100
11101101101011111000111101111100110011111011001011101111101101010100010111111110110111111101100101010
10000000000000000000010000010000000000000000000000100100000000000000000000001000000100000000000000010
11011110000110111111100101101011011110110111101100111110111101111101010111110110101111001111011001110
00001000000000000000000000000001000000100100000100000000001001000001000000100010100100000000000000010
01101001011111100100111110111111100101111110101101001011100111110101101101110010111011001011111111011
00000000000000000000000000010000000100010000000000000000000000100000000000000000000001000000000010000
10111010111010111111010111101101000111111111110110000011010010011111101001011111011111011110110110111
10000000000010001000000000000000000001000000000000000000000000000000000000000000010000010000010100000
11101110010101011101111010111101101111011011011111010111111110000110110101101011110111101110011010111
00000000000000000100010000001000100100000001000100010100000000000000000001000000000010001000000000000
10101010110111101110111110111101101101111101010101101110011111110111100111111110110010010111111011000
00000000000000000010000100010000100000000000010100000000000001000010000001000000000000000000000000000
01101110000111111011011010111111100110110111111001110111011101100101111010101111110011110111011101011
00000000000000000000010000000000000100010100000001000000010000000000000010100001000000000100001000000
01111110101110101100001111111000111111110111011101110111000111110011110100111111000111011011110111010
00000000001000000000000000010000000000100010000000000000000100000000100000000000000001000000100000010
11111001101101110101101101011110101110111111001010111110011110111101010101101011011110111000110010110
00000000000001000101000101010000000100000000001010010000000100000000000000000000000000000000000000010
01111011010111110011110111010111011010110111101001111101000111011111111111000011110011111111011000110
00000000010010000000010010010000001010000000000000000001000000000001000000000000000001000000000000100
01011100101011011110001011011111101101110111101111011111110010011010110011010111001111110101110001011
01000100000000000000000000000000000000010000000100000000000000000000000000000000000100000000000000000
01110110011110101110101110110001101111110101101101011110111101111001111101100100011011111100001100111
00000000000010101000000100000000000000000000000100000000010000000000000000000000000000000000001000000
11111010010111111001111001000111111010111110111110111110011011111101101110111011101101100110111100111
00000000000010000000000001000000000000000100100000100000001001000000001000001010001000000000001000000
10110110111001111111100000111011011010101010111111101111111110101001001101111011110101011110101110011
00000010100000000000000000001000000000000000000001001000000000000000001000001010000000000100000000000
01101111011111101100101101011110111110110111001100111110110011111010110010101011011110101111011110101
01000100001000000000101000000100010000000010000000000010000000000010100000000000000000000010001000000
01011111011110111101111101110100110110111011010111101111011111110011101111011111110111101110110011011
01000001000100010000100000000000010010000000000000100010000100000000100000000100000100001000000000000
10011001001111101101101111101001111110111100111011010111101101110111101111001100101111011010101101101
00000000000000000000000000000000010000010000000000010000001000000001000000000000000000000000101001000
10111010111110110111011011110110110111011011111101101101101111011101010011110111100111011111011101011
00000000001000000010001000100010000001000000001000000000100000001001000000000000100000000001001000000
11110110111101100010111110111011111101101111101011011101111101001011111010111110110111111100110001110
00000000100001000000000000001000000001000001001000000000000000001000010010010000000010000000000000000
01101101111110111011010011111010111111011101111100110011011111101101110100101111110110010001111110110
00101000001000000000000000100000000100000100001000000000000000000001000100000000000000000000000010100
10101010011110111111101111011110111011110111011110100111101110101101111101111101011110011100110111010
00100000000000000010000100000100001000000000010000000000000100000000000001000001000000000000000000010
11110101101010011001110100011011111010111111001111111000111111011011101001111111110101010111001101010
00000000000000000000000000000000001000000100000000100000000000010010000000000100000000000000000101010
11100110110101101111110111111100101011111011110111101110011001100110111011001111010101010111100110111
00000000010100000000100000100000000000100000100000000000000000000010000000000000010000000000000000000
01111100111011111011110011011111000001110111011001011110111101111100010100110110111111101100111111101
01000000100000100000000000000000000000010000001000000000000000000000010000000000000001000000000100000
10101111011110101001111011010001111011110110000110101111100110111111101110111110100101011011101110011
00000010000000000000010000000000000000100000000000000000000000000001000100000000000101001000000000000
01011111110011101101001010111111011010011010101111111111100100111001110110111011011111011011011100111
00000000000000000000000000100000000000010000000000100000000000000000100010010000000100010010000000000
11011110011111001011111110111011100101111001001100111011111011101101110111111011111011101110111011101
10000010000001000000000100100000000000000001000000000000000000100000010000010000100000001000001001000
11110111011100110111111010110100111110111111110100001110101111110101001001111010111111110001100100110
10000100000000010000100000000000000100100000000000000010000000000000000000000000000000000000000000000
11011010111111101010000001111110100111111111101111000111101100011011010010111111011101111111110010101
00000000000000000000000000000100000000001000001000000000000000000000000000000000001000001000000000000
01111010111110110101001001001110111100101111100101011101100101111011110111001101110111100111101100011
00100000000000000000000000000000000000000000000000000000000000010000010000000000010000000000000000000
01101111010111111011111110011101110111010111101101111001111011111011011111011011011101010111011011101
00100000010000010000100000000100100000010001000000000000010000000010000010001000000000000000000001000
01101010111100111110111101101110001111011010001101111010011111110111111100001101101110110110011011111
01001000000100000000000000000000000000000000001000100000000001000000000000001000000000000010000000000
11110111110011111100110111101011111011011011011101101011011011101111111101010010110011111011101110101
00000100000000100000010010000001000001000000000000001010000000100001000000000000000000010000000100100
01101111100111011101111110100010110100111111001101010111011101101011110110101110111001111100111111011
01000010000001010000000000000010010000000000000000000000000000000010000010000000000000001000000001000
11101101001111110110111101101101111000101111111101011111000111101101110110010111111011011011110111101
00001001000000000010000000000000000000100000100000001000000000000001000000000001000001001000010000000
00101011111111011101110111010101100111110111001010111110100001101111110110110111011111010010001111110
00000000000100010000100100000000000000000000000000010000000000000000000000100000000000000000000000100
01111101101110111000111001110111011110111011011001111110110001001101111010111111010111111101011111110
00001000000000000000000000010001000000000010001000000000100000000000000000000000010000010001000100000
11111010111101110110110110101011000101111011111010111010111101111011010101111110101011000101011111110
10000000100000000100010100000000000000000000000010010010100001000000010000000000000010000000000000000
10101101101111101111110110111110111110010111101011011011011110101110101111110011001110111110001101101
00000000000010000010000100000100000000010000000000010001000000000010000000000000000010000000000000000
