00000000000000000000001000001101010000010000010010000000000000000000000000000000000000010000000001000
01001101110101111101110111011110101110110111010111010111111100101111000001111110101101101011101101011
00000000000000001000100000000100000000010100000000000000000000000000000000010000000000101010000000000
10011100111101110110111110110101111011110110110010111100111110011111101111000111011111001111110111101
00000000000100000010000100010100001000010010000000000000000000000010000000000001000000000100000100000
01110110111011111100111000011011011101001111010111100000111111111011100010111111101110111101110111011
00010100001010000000000000000000000001000000000000000000000000000010000000000000001000001001000100001
01110110111001111111011010011011101011101101011111100011111011111001101110111001111011011101101101111
01000100001000000010000000000000000000000101001000000000000010000000100000000000010001010001000100001
01111100111011011011011110100010101110110110101010101111011111110101101111001110111001010111011111010
00100000000001010000000000100000000000000000000000000000000000000100100000000000001000000000000000010
10111101111100110101110001110011111011011011111101101110011111011110111101011101111010111101111111100
00000001000000000001000000000000000010000000100000100000000001000100000000010000010000000000100000000
01111101110011101110111010111111000110111011101110111111100011111110001001101110110111011100001011110
00000100000000000000000010000000000000001010000000010000000000100000000000000000000000000000000000010
11110011001011110101100111101110111100110010111011111100111011101111101110001111111000110110011101111
00000001000000000000000000000010100000000000000001000000001000100000001000000000010000000000000000000
01011111011101011111011100110110010111011111010110001101111010111101011101101111001110011011110111011
00000001000000000000000000000000010000001000000100000000000000000101000000000000000100000000010010000
10100110010111111101011111100111110100111101110110110111110101101111011110001111011110111011101111001
00000000000000000001001000000001000000000000000000100010000000100100010000000000010000000010001000000
01111011010111101111100101100111101111001111100111011011010101110011101111011101101111001011011011110
00000000010000000000000001000000100000000000000100000010000000000000000010000000100100000000000000010
01101100101111110111100001011101001101111111101110111111001101111111011111110011101111111000111101011
00000000000000000000000000000100000000000001000010001000000100001000010000000010001000000000100000000
01111011101000111101101011101110110111101011001110110110110110111110011101011001001011111100001110111
00000000000000000000001000100100000001001000000000000000000000000000000000000000000001000000000000000
01111101000011111011111010110111011110101101010111111011011101110100111110011111011101100011111111110
00000100000000000000000000000001000000100000000000100000000100000000000010000000000101000000000100000
10111110111001011110111011111100100111001110111001110010110111111101111001101111010101011101101001111
00000000100000000000100000000000000000001000001000000000000000001000000000101000010000000000000000000
11010101111011100111110111101010110011111100011111001101111100110111101011010111010011110011110110101
00000000010000000000000100000000000000000000000000001000100000000000000000000000000000000010000000001
10110011111100111000111110110110111101101011101110110110111011111111010101010111111001111111001101110
00000000000000000000001000010000000000000000001000000100010000010000000000010001000000001000000000010
10110111111010111011010111011111011000110111111011011111000011110101110110111011010111101011111010101
00010000010000000000000010010000010000000000000010000000000000000000100000010001000000000000100010100
11110111111100011111010101101100001001101100111101101110101111110110111011101101111101101111111001110
00000100000000000000000000000000000000000000000000100000000010000100000001000100010000000010000000000
11110011111011101011110111111010011100101111101101001111110101101010100001101011110111101101011111110
00000000100000000001000000000000000000100010000100000000000000001000000000000000000000000000000000100
01101111110010111111100001111000101101011111011111011111001110110101111010111110101101011111111001101
01000000000000000000000000000000000001000010001000010000001000000000000010000100100000000001000000000
11111001011011110011101011001111010101011110110110101011001111110100111101011001111011111001011011011
00000000000010000000000000000000000000010000000010101010000000010100000000000000000000000000010000000
01111111101100011111110011000011101101011011110101100111001011111011011111101111010010101011111100111
00000100000000000000000000000000000001000000000100000000000000000000000100000100010000000000000000000
11101011001101011110101101111111001110111011011101111011010111011010111111100111101110111011011001111
00000000000000001000000000100000000100010000001000000001000000000000000100000010001000001010000000000
10111111010010110011110011110110010101101110111110101111011101100010111111010101110111100011110111011
00000000000000010000000000010000000000000000000000100100010000000000000000000000010010000000000010001
11101110111101001111100011110011100100000111110111111011011111001111110011110111111101101010011110110
00000100000000000000000000000000000000000000000000000010000010000001000000100000100000000000000010100
11101101111111001110101110111110111100101111011011011101111001111110101100110011010110111101111011110
00000000100000001000100100000100000000000001000000000101000000000000000000000010000000000100010000010
00111111110111011110110101011110011011110011111011111001001111111110001001011101111101001111011101011
00000010000000010000000000010000000001000000010010000001000000000000000000000000100000000010001000000
11111001101110111110100101011110110011111101111011011111001110110110101111010010111000111100111111101
00000000001000100000000000000010000000000100000010000000000100100000000010000000000000000000000001001
01101110110100111111101111101111000111111101111101100101111101011011010111101011101111110011011101101
01000010100100000000100000000100000000010001000000000100100000000000010000000000100000000010000000000
11110111100101001111001111101100111100111101111011011011010101111100100110111111110111110001001110011
00000000000000000100000000000000000000100000100000000000000000000000000010000100000000000000001000000
01101111111100101110011101011111011010101111101110100000110101101111111111101111010111110101111011110
00100000100000000000000001000100001010100000100000000000000000000000000001000000010000010000000001000
10011111111100110110111011011101101011111101111101101110011010011101000101110111111111001101110110011
00000001000000000000010000000100100000010001000000000000000000010000000000000000010000000100000000000
11110011101001111111010011011111111001011101101100110111100011111011011011100110010101010111111101111
00000000000000100000000001000010000000000001000000000000000000000010000000000000000000000000000100000
01111000011111111101001100010101111001111011111010111111001011001011101110011101101111011011111001101
00000000000000000000001000000000000000000000001010000000000010000000000000000100000000000010000000100
01010111101110111011010110101111011100110101111110001010111111011101101101010111111001111101011011000
01000000000000100001000000000001000000000000000000000000000010010000000000010100000000000000000000000
10111111001011110101011100111111001011101110111010101011111110000111101101101100101110111011100111110
10000000000010000001010000000010000000000000000000101000000000000000101000000000000000001000000000000
00010111110111110110010101011010110111001111111110111001111011101101111010111111010101101011111101100
00000000000000000010000000000000000000000000001000000000010000100000000010000000000001000000000000000
01111111011111001010111001011111110001101111100111011101110011011011111101111000001011101111010111010
00010000010000000000000000000000000000101000000010000001000000000000100000000000000000000000000000010
11001111111001110111011110101111010101011111011110111110110101011010110110011111111110110110101011001
00000001000000000010010000100000010101000000010000100000000001001000000000000000100000000000000000000
01110101111110100110111110110111011011001011111011101111110110110101001110110111010111111011011011011
01000100000000000100000000100001001010000000000000100010000000010000000000000000000001000001000000000
01101111111101011111011110011110101111111001011011111110111010110101111111001001011011110000111101101
00000000100000000100001000000000100000000001000000010000100000000000000000000000010000000000000000000
01110111100101111101001110010101111011011110101111101111110100111010111101101111101111011101101111101
00000000000000000000000100000000000000000010000000000100000000000010000000100000001000001000000100000
10011110101111110100010011011111101111001110111111100011001111101110011011111000111101011011111011011
00000000000100000000000000000001000000000100000100000000000000100000000000000000000000001000001010001
00110101101101110110010111111110110110100011111010011010011111100011111011011000111011110111011101101
00000000000000000000000000100000000000000000100000000000000000000000000010001000000000000000010001000
01111100101111101111011010011100100001111011111100010111110111001100101111010111101101011011111011011
01000000000000000000000000000000000000010001000000000000000000000000100010000000000000001000001001000
01111011011110011111101101111100110001100110111001110001011010111111111100111101111111011010110111101
00000010000100000001001001000000010000000000000000000000000000000000000000000100001000000010000000100
01111111110101101111100111011111110101110101000111011011100111110011111001011101101101111011011001101
00000100000100000000100000000000000000000000000001010000000001000000000000001000101000100000000000000
11100111111101111011101110110111101101111100011001110111010011110010111111101101110011101111110011011
10000000100000100000100000010000001000000000000000000001000000000000000000100000000000000010000001000
10101110111011101011101110110111110001011111101111000011010111110111011111011011000111011101010110111
00000010100000101001001000000000000000000100000100000000000000000001000000000000000000010000000000000
