00000000001000100000000000000001000000000000001000000100000010000000000000001000001000000000000000000
00111101111100101111110110101011101011011101011111101011001111110111100111101101111101011110111101111
00000000000000100100000100000000000000000001000000001000000000000000000100000000100000000100000100000
11110110011010101010010111101101111110011111010110011110111011111011011101110111011111111010001001111
00000000000000101000000000000000000100000001000000000000000010000010001000000010000000000000001000000
01011101110111111100110111110011111110110100001111010111101101111001110110111100110011111101110001110
00000000010010000000010000000000100000000000000001000000000100000000000000000000100000000000000000010
01111101011110111111111010111110110110110000111111100110011110111011111001110111010101101101100111101
00000100000010000010000010000000000000100000000000100000000000000000100000000001010101000000000001000
01011011011111110101011110110111011111100111111001101001001111111101101101110100110101111011110110010
00000000000001000000000000010001000010000000000001001000000000000101000000000100000000000000000000010
01111111100111101100010101100101111011011011011110101110111011110110111110111101110110011011001111110
00100000000000000000000100000000000000000001001000000000100010000000010000010000010000000000000000010
10111101101111101111001110101010011101110110111001111100010111011011010111101111010010111101011111001
00000100000000001000000000000000000000000100100000000000000000000001000000000010000000000000000000000
11111100111111100111101101101110111101101001111110011001110111001011110010101111011010111110111101101
00000000100000000100000001000000100000000000000000000000100000000000000000000001010000000010001000000
11001100101111011011101101111101011010111011110010010111111011010101110111101100110101111101011111010
00000000000000000000100000001001000000000000000010000000000000010000000000000000010000000000010000000
11110111111001111110101010110111000011110111101100101111011110010101111111100101101011101101110111110
00000100000000100000000000100100000000000000000000000000001000000000000000000000001010000000000100000
01011110111110110111111011100011110100011011011111111011001111001101101111101011111101101010111011110
00000010010000010100000000000010000000000000000010000000000000001000000100001000010001001000000000000
11011110101110110110111101111011101101111011110111010111100001111111000000111011110111111111011101101
00001000000100000010010000100000000100010001000000000100000000000001000000000000000000000000010000100
10111111000111010111110110101111110110110111011111001111001010111101011111111000011101111001111011010
00000000000000010000000000100010000010000001000001000000000000000000000100000000000000010000000001010
11011011110011111111110011001100111011101111011101000111010011000111100111101101111010111011110010111
00001001000000001000000000000000000000001000010001000000000000000000000000000000000000000000000010000
11110101101010111111010111110111111001011001011101011100111110101011001100011110111101111111010111010
00000001000000000000010000000010000000000000000100000000000000000000000000000000000100001000000001010
10101111001110111001010111111101111011101001010111111011011101110111110101010100011010101100101110111
00100000000000010000000000001000000010000000000000001010010000000000000000000000000010000000000000000
00001110111101111011011011111111000010110011111011110111101111101010011111111111001001011010111110111
00000000000000000001010000000000000000010000001000010000100000000000000100000000000001000000000010000
01010111111011101011110011011111111011001100011101001011111010011111011001011111011110101110110110110
01010000100000101001000000000000000000000000010000000000001000000000000000000001000100100010100100010
10111110011010111101011110110110111101011101111011111010100111111011001110011100101111110111101011010
00000000001000000100000000000000100000000001000001000000100000010000000000000000000000010100000010010
01111101100011111111101101101111011110011111011110001111101110111011001111101011100110111011011011101
00001000000000000010000101000000001000000000010000000000100000000001000000000001000000000001000000000
11110101110101011111110111011011011110011011111101011011101110111110011111110110010111101011111100011
00000100000000000010000100010010000000001000001001001000000010000100000010000100000000000000000000001
10111011001110110011111110110010110111110111011001010111110111100111101110001110011101111011111001011
00000000000000100000010000010000000000000001010000000000010000000000000100000000000000000000000001000
10011110111100101011111101011101111110001011001111101100111110111001111011101011101111110111011111000
00000010100000000000000000010000000000000010000001000000000010000000000000000001000100000100000000000
10101111011110111001001111111001011101011111110011100111011001111010101110101111101101101111111000110
00000010000000000001000000000000000100000001000000100000000000000000000010000001000100000000000000000
01111001011111001101111011100111111100011110111111101111100111110110110101101011110111011101110110111
01000000000000000100001010000000100000000010000010000100000010000010100100000000000010010000000010000
01011011111111010101101110111100111011011011110110111101101011011110010101111110001011011110111110111
00000000010000000000000100000000000000010000100000010000000000000000000100001000000000000000001000001
11110100111110101110110111101101111110111100111010111101100001011101100111010011101101111100011101111
00000100000000000000100000000100010000000000000000000000000000000000000000000010000000010000000000000
01111001110011110011111110110111111100010001101110110110111111100101111011100011011001001111111011100
00100000000000100000010000000000000000000000100000000000001000000100000000000000000000000000000000000
01011011011001011011101110110111101111010110001110111011110110101111110101110010111111010110011101011
00000000000000000000000000100000001000000000000000010000010010000000010100000000000010000000000000000
10111010111111011010011011110111110101101111011111101011101100001111101111110111011110101110100111110
00000010000010000000000000010000010100100000001000001010000000000000000010000000010000001000000000010
10011111010110111101101101011010111010111000111010001111111110111001111000111111010111101111010110111
10000000000010000000001000000000000000010000000000000000000010000000000000000010010000001000010000000
10110110101101111110101101101100100111111101110001110101011011101110011110111001101110110111011110011
00100000000000001000000000000000000000010000000000010000000000000000000000000001001000000010000000001
11011010110111110110101110110111010001110101001011111111010010101111110111111011100101011111110011101
00000000000100000100000000000010000000000000000000000001010000000000000001000000000101000010000000000
11011011101101010011111111100111010110001111110111011010111110001001011110110101010101101111111011110
00001000000100000000000100000010010100000000000001000000000000000000000000000000000000000001000001000
01110001100111111101001010111101101111101011001000011110011101110111110101111010110101011110011011101
00100000000000000000000000000000000100000000000000000000000000000000100101000000000000000000001010000
10111101111111000111101111110011111110001110101101110110111010111101011010000101111011111110011111110
00001000000000000100000100000010000000001000000000100010000000001000000000000000000000000010000000100
01011010011101111101110011011101111110010101111001110111101100011101110110110110101101011110110111101
01010000000000000001000000000100000000010100000000000100000000000000100010100010000000000010100000000
11110101101110110111111110101001011100101111111101101011111010001011111111111011010111110001111111110
00000100000000010000100000000000000000000001000001000000000010000000000001000000010000000000000100000
01110100111101011110010011111111111101001011110111111001101101001001100110111111101111001110110111011
00000000000000000010000000000000100000000000010000000000000000000000000000000010000000001000000001000
01010111110111111101011110000111010011001111111011110101111011101110010111100111100101111110111010111
00000000010001000001001000000000000000000000000001000000010010000000000000000001000000000100000000001
01110101111011011101111011011111100110001111010110111111111001001111110101011110111001101110111011101
00000000000000010000000010010000000000000001000000000100000000000100000001000000000000000000100001000
01111111100101011111101111111011111000101110111101100101110111010111110001011011001111111011100111110
00100000000101000001000010000010000000000000000000000000000100000001000000000000000000000001000000100
10111010011100111101111111101010011110011111111001011110111110111111011011001111110101111111010101011
00000000000100000000001000000000000100000000100000000010000000010000010010000001000000001000000000000
11100101111001011110101011011011111101111101011101111110111101101101001101100101110011100111111001111
00000000000000000000000001010001000001000000001000001000001000000000000000000000000000000000001000000
10111010111100011111100110011110110110111011001111110111111001101111110101100111111001101001101001111
00000010000000000000000100000000010010000001000000010001000000000010000000000000000000000001001000000
01111010001111011101110110011111110111010110111101011101011111101110101010111110000111110011111010101
00000000000000001000100100000010000000000100001000000100000001000000100000000000000000000000010010100
11100111100111111100011101101110110110101101111101011000110111010111001111001101111011011011111010101
00000010000000000000010000001000000000001001000000000000000000000000000000000100100000001001000000000
11011101100101011010011111111010101110111110100010101110011111101011010111110111100111110000111110110
00000100000000000000000000000010100000000000000000000010000001001000000000000000000000000000100000000
01101010111111010111101111110111111010101011100101011111101011100110111111101110011111011101011111100
00000000000010000001000001000001000000000000000000000100000000000010000100001000000001000000000000000
10110101111101011001110101111100111111100111100111101001111111110011110010111111101110111010111011001
00100000000000000000000001000000001000000001000000000000001000000000000010000010000010100000000000000
