00000000000000000000000000000000000000000001000000000000000000000011000000000001000000000010000000100
11111100011011111111101011111000110001101110111110001011110111110101111011101111110101011111011111010
00000000001000010000000000000000000001000000000000000010000010000000010001000010000001000000001000000
11110110011111000101101111111000100110100111111111001011101011001011111110111101010111101111100011110
00000100000010000000000000000000000000000000000000000001001010000000001000000001010000000000000010000
01111110100111101111110011110110110111101011111011010111011000111110011111101110110111011101001101111
00001000000000100000100000010100010001000000100000000000001000000000000001000010010010010000000000000
10110011011111011010011101111110110001110111111011011111101001110110111111101011110011001110111111100
10000000000010000000000000001000100000000000001001000000000001000000010000000010000000000000001000000
11001110011111111110010101011101110001110110011000111111110101000111111101011101111011110111111001110
00000010000001000000000001000000000000000000000000000000000000000000100000000100001000000001000000000
11100100001111111001101110110110101100110111010111101101111011111110001011011111001100110110111111011
00000000000000000000000000000000101000000000000001000000001000010000000000000001000000000000000010001
10110110111101110110111110011001011011110101101011011111100110100101111110101111101011111101110011111
00010000000000000100000000000000001000000000100000000000000010000000000010100001001000000001000000001
11010111101100110110111011111010011111010110111100100101111110101011111011111110110100001011001111110
00000010000000000010000001000000000100000000000000100000000000000000100010000000000000000000000000000
00111100011111101110110110111110111010111111001111111111100100110111110111100110110110111100110011101
00000000000000000100010000000010000000001000000010000000000000100010000000000000100010000000000000000
10111101100101110101111001110111101111101110100111111011111001110110010011011100110111010110101110101
00100000000000100000010000000000100010000000000001000000000000000000000000010000000000000000000000100
10111010110111011011010100011111010111110101011111101110111101010111111011011110011111110001111111001
00100000010001000000000000000000000000000001000100001000000001010000100010000100000000000000100000000
10110111111110000010110110110111010111011010100111101110111011110101111010011111011101111011101111011
10100000000000000000000010010100000010000000000000000100001000000000100000000001010000010000100010000
11101110111100101101111010101101111011101100110011011111100011111101101110101100100111111110011111100
00001000010000000000000010100000000010000100000000000000000000000001000010000000000000000000001000000
11110011110010110011011111010111101111011111010101101101100011001110111011110110110111100111101110111
00000000000010000000000000010000100000001000000000000001000000000000000000000000010010000000000100000
11101011111001011100101100110111111101001101110110111001011110001101010011101111011100101001111110111
10001010000001001000000000000000000000000000000000000000000000000001010000000000000000000000000100000
10011011101110110010111101011110110100111110110111111011001110111010001111011100111111111000100110110
00000000000010000000000000000000000100000010100010000000000000000000001000000000010000000000000000100
01111111101010111011110011110110111101111011101101111110100110101100110111101110101010111000110111101
00010000000000100000000010000100000000100000101000000000000000000000010000000000001010000000000000000
01110111110011100111101101101011111011101111100111011011011001110011110111100111110110011011110110111
00000000100000000000000000001000100000000100000000000010000000000000000100000000000000010000100000000
11101101011011111101111011001011100011110101011110101111111010101100010111110101111011011010111001100
00001001000000100000000000000000000000100000000000000000000000000000010000000001000000000000000000000
01110111100111011111011110001101110110101101111101010111111101111101110000111100110111011110101101110
00000000000001010000010000000000000000000000100000000001000001000000000000000000000001000000100000010
01110101010111010111111011110111111011001011110010110011111111011101000011100001011011111111111111110
00010000000000000000010000010000000000001001000000000000000100000100000000000000000000000000000100000
00111110111011100100110110011101111101110111111000100111111101011011011011000111001111111011001110111
00000000000000000000000010000000000100000000000000000001000000000000010010000000000000001010000000001
10111011101110010011111001011101111010001101110101111110110111101110001111111000010011111101011101101
00000000000000000001000000000000010000000000000000000100100000000000000000000000000000100000000000001
10001111111100110011111010111110100111011110110110101011011101111001101011111111101010011010111110101
00000000010000000000000000100000000001010000100000000000000000000000100000010000000000010000000000000
10100111011101111001101110010101111111010011111111011010110011101011110110001011110101111111101101101
00000000000000000000000000000100010000010000001000000000010000000000010010000000000000000001001000000
10011110110111011101110111010111101110101101101110001101111111100101010101001111111110110011010111011
00000010100010000000000100000001000100000000000100000000000010000000000000000000000000000010010000000
11011111010110010110101110101101111011010111110011010111101101110011101110110111101110101110110110101
10000000000000000100101000000101000000000010000000000010000101000000100000010100000000100000010100101
11101101011111100101111101010111010011111000101011111111110011001111010111110011011111111000101110101
00001001000000000001000000000000010000000000000000000010000000000001010001000000000100000000000000100
10111001111110111101001111110101101110110011110010101011111011110110110110011100100001111110111100111
00100000001000000000000010000000100100100000000000000000001000000010000000000000000000000000000000000
10111110101111010110011111111000111000110011110011011111111011000110111011011110101111011011001101111
00010000000000000100000010000000001000000000000000000000000000000000000001000000100001001010000000000
11110101101101111110110001111110101111100111011011101111111111001100011101011101101101111010110101111
00000001001000010000000000001000100000000010010000100000000000000000010000000000100000000000100000000
11101110101011011101111111010111101101011011010111010100110110111000011111011100110001111111001111011
00000000001010001000010000010000000001001010000000000000000000000000000000000100000000000000000001000
10101101111010110111011101011011110101010111111011101001101111011110111100111110101101101010111110011
00000000000000000100000001001000000000000001000000000001000001000000100000001000000000100000000000000
10110000111111110011110010101111110011111011010101101111111001011001111101111000110111111010100110110
00000000000000000000000000100000100000000000010000000000000001010000000000000000000100000000000000100
11011110111001101011101111010111111100110100001101011111010011001101101111111011101011101000101111110
10000000000000001000000000000010000000010100000000000000000000000000000000000000000010000000000000000
10101110101101101110101101110111110111011001100101111111110101101011100001111111011010110110101101101
00101000000101000000000000100010000010001000000000000000000000000010000000000000000010100000000000100
11101110010011111111011011011111001101110111010100111001111010011011110011111100101101111101101101111
00000100000000000010010001001000000100100100000000000000000000000000000001000000100000000100101000001
10111111101011110011100111010111100101111101010010011011101011101011101011110111110111111101011000011
00001000000001000000100000000000000000000101010000000000000000000000000000000010000010000000000000000
10011001011010111101011111111110001110111010111101111010111101101001111101001001111110110100111001111
00000000000000000000000010000000000100010010000100000010001000000000000101000000000000000000000000000
10100011101100111111110000010101101111111111111001101110100110110111011001001100110111111101111110001
10000000000000000000100000000000000000000000100000000000000000000000010000000000000000000100000000000
11111000111011101111110110001011110110111011011111011011011111110111100011111101010010110101111101101
00000000001000000000000000001000000000100000001000000001000100000100000000010000000000000000000000101
11100111110111011110111100111110110011111010110101111001111010001110111101101101111001110111101010111
00000010000010000100100000000000000010000000100000010000000000000000000000101000000000100010001010000
11011010111011111010110110111011011101011101111101101010000011001011101100111111110111011100110001111
00000000000010000010000000001000000101001001000000000010000000000000000000000000000000000000000000000
01011111111100111100111011011011011010111011011111010010111011111101001101101011011000011111101101101
01000001000000000000100001010000001000000000000100000000000000000000000000000000000000000010000000100
11101111011001111100111101011011110101101111011011110111011101111101111100011110010101111111110010111
00001000000000000000100001010000100100000001001000010100000100000100100000000010000000000000000010000
01110111101111110011101010111110110101101111011111101101010001111011110111001101001110101011011111011
00010000000010000000000000001000000100000000010000000000000000000010000000000001000000000000000001000
01111011111011101100110110011101111101111001010011110111001111101111011110010110101110111011111101001
00001000000010000000000000000100000000000000000000100100000010000100000000000100100010001001000000000
10110111100110110111001111111001011011011110101111101111101101111000110111111111011011110011001111111
00010100000000000100000010000000000000010000100001000001001000001000000000000010000000010000000000000
11001111011001110111011001111100111110010010111111100111011111100001111100110101011110110110111011011
00000000000000010001010000000000010000000000000010000000000000000000000000000000010000000010100001000
10110101111011011000111111111011100110111010011110011100010111001110110110111101111001111111101011000
00100101000010000000000000100000000000100000000000000000000000000000000000010000100000000000000000000
