00000000000000000100000000000000100000000000011001000000000000000000000000000000010000000000000000100
10101111010011011011111100111101110111111011100111000101111011010101111101101110100110111111110110101
00000000010000000000010000000000000100000000000000000001000000010100000000001000000000000010000000100
01110101011100101101111010101111110101111011010110101111011110101001010111001001011101111111001011110
00000000000000000000000010000000010000001000000000000000000000000001010100000000000000000000001000000
11110000101111110111100111110010111111100111100011111010101101101101101010111110110111110100111110110
10000000000000010000000000000000010000000010000000000000000101001000000000000010100000000000100000000
01011111011011011101110110111010011101100111000111111101010011011111110011101001111101101111011101101
00000010001010001000010100000000000000000001000000000000000000000100000001001000000000100100000100100
11101111111011001110110100110011010101110111001110111010110111011111101000111100011111011010111110110
00001000000000000000000000000000000100000000000010000000000010001000000000000000000010000000000100010
01101111011101101011101111101110110111011011010101111010110111111101101011111001011010111011011100111
00100010000000001000100000000100100100000000000100100000010001000001000000001000000000000000000000000
01110111001011010111010101101111011100111110001111111111110010001110011001101011110111011010011111101
01000000000000000000010100000001000000000000000001000000000000000000000000000000000100000000000100000
01111011111111001010111010111110101101011111001101001101011111011011111101010110111110111011010101111
00001000001000000000001000000000000001001000000100000000000000001000010000000000000100000001010000000
01111011110100110111110011111011010110011011011111101011010111011111100101101001111111011101101100111
00010000010100000000010000001000000000000000000000000010000001001000000000001000000010010001001000000
00111111001111110101111011111111001001011111100100110001011111101101110101110111011011101110111111110
00000001000000000001000010000000000001000000000000000000000000000100100100010100010000000010000100000
10111101101101111011111011111001100110111111011111011110001110111110110011101010101011110001111111101
10000000000100001000000001000000100000000001000010000000000010100000000000000000101000100000000010000
11011100011111101110111110011011101010111001001110100111111001111111100111111011111000101110101111101
10000000000000001000010000000000000010000000000000000000001000000001000000001001000000000000000010000
11101111010111011000111110011011001101111110111011101001101111111011110111110111110011101011111000111
00000100000000001000000000000000000000000010100000101000000000010000010000010000000000100000000000000
01010011111101111100001001111110111110101111100011111110010011001111010111011101101011111011111011101
00000000000000100000000000000000000000100000000000100000000000000001000000000100000000000010000010001
11001111110111101001111100101110111111001101011011011001111011111101011101111100111011101011111000111
00000010000100000000000000000010000000000101010010000000000001000000010000100000001000000000000000001
11010001111011111010011111011110011111100111010111010110111111101011010101011111010111111001011011101
00000000000000000000001000010000001000000000000010010000001000000010010101010000010010000000001000000
01111001011111011101111010011011101111011101100001111101111110011110110111101101001011110111111010111
00000000000001000101000000000000000100000100000000000000001000000010100010000000000000000010000010000
00101111101010111011100111111111011100100011101110111110111101011110110111101111111100101111010111011
00000000000000000000100000000000000000000010000100000100000001000100000000100010000000100001000000000
00111111100011111011111011011010011100101100111011111111100101010101111010110110111010101011111101101
00000000000000010000000000000000001000000000000000010000000001000000000000000000010010100000001000100
01110111101111011011011111001111001110111100100110111111101100001101101111001011001111111011110111000
00000000100000000010000000001000000000100000000000000100000000000000000000000000000000100000000000000
11000111110110111110100011111101101101010110101110111101110111101111101110100011010111110101101111010
00000000000100000000000000100000000000000000001000010000010010000100000000000000000000100000000000000
10111011010110110111011111011100110111000111001111010111110000100111111110110001101011100111110111010
00100000010010000000000100000000000000000000000000000000000000000000100000000000100000000000100010010
11011101101011111101000111101011111110111101110111001010101111110010011111010000000101111111111111010
00000000000001000000000000000000100000100000000000000000100000000000000010000000000000000000000000010
10111101111011011010111011111011001111100101011101010111001111111011011101111110111011110111010001111
00001000010000000000010000000000001000000000000001010100000000100000000100100000100000100100000000000
10010110111111110110011011011101101110111011101111011110111101001110110101011101011011010111110111100
00000000000010000000000000000001000010001000000010001000000000000000000101000000000001010001000000000
10111101111011100111111110011110010110111100111101111110111100111011011111010111110011001111110111110
00000000100000000001000000001000000000000000000100010000100000001000000001000000100000000000010000000
11001110110111100110011111101111101110001110111101110101111111010011101101111110010011110011101110101
00000000000001000000000000100000000100000000000000010000000000000000001001000000000000000000100100100
01111101011111001101111101000111110110111111101110010110111011101101100111111111011010111001010110111
00000100000000000000100000000000010100001000001000000000001010001001000000001000001010100000000000000
01011010011101011111001011111110110101010101110100111011111110001010111111110011110110111010101101111
01010000000000000001000000000000000100000000000000000000010000000000000010000000010100000010101000001
01110100111010011011001111111011101101101110111110011100110010101111011010010110111110010111001111110
00000000000000000000000000100000000101000100010000000000000000000000001000000000000000000000000000000
10111011111011100110100111011110110100010111111111000111011110001110111111110011111001000111101010011
10001000000000000000000010000010000000000000000000000001000000000000001000000000000000000000000000000
11100111011010100111011111010111101110111111101111011010111101011011111111111000111000110101111111001
00000000001010100000000001010010000100000100001000000010010000001000001000000000010000000000000000000
01011110111111101101110110100000110111111011011011011110100101111101101111011011101111100111100101111
01010000000000000000000000000000100000100010000000000100000000000000100000000010000000000100000000001
10111101110101111011101101111101111001101110111100110110111010110110101001001001101101001011111111111
00001000000000010010000100100000000000001000000000000000100010100010000000000000000000000000000000000
01111010111111110010000001011111101010110111010111001111110011110111000110011101101010110111011001111
01000010100000000000000000000000000000000000010001000000000000000000000000000000000000100100001000000
01010100111101011111110101011110111111010111010111011011010111011111100100111011111111011000101100101
00000000000000000000000000010000010000000100000000001000000000000000000000000010000000000000000000100
11101111100011111110001011011011101101101111001011101111110101111001100111010011101111111101110111001
00000100000000010000000000000000100101000000000000100001000100001000000000000000000000010001000000000
11110101110001111111010111110011110011101111011110101111101111011010111101010111101001101111100111010
00000100000000000000000100000001000000100000010000001000001000001000000100000000000000000000000000000
11011010011110011111010111101110111011111011101000111011011111111111101100100110110111101101101101110
00001000000000000001010000100000001000010000100000000000000000100000000000000000010000001000101001000
10110111011010010111001001111111110111101010011010111111011111111101011010011111010011111101011101110
00100100000010000000000000000000000010000000000000000001000001000001010000000000000000000000010000000
11011110111100101111101011100111101111110101110101111011011110000110011010011110111110101011111110100
00000100000000000000000010000000100000000001000101000000000000000000000000000000010000001000000000000
11011011100111111110111000101110011111110010101101110101101111101100111011111110011110111110010011110
00000000100000000000000000000100000000000000000000100101000100001000000000100000000100000000000000000
11101010111101110111111010110110110110110111110011111110111001100100011110111010011111010101110101110
10000000001001000001000010010000000000000001000000100000000000000000000010010000000000000000100100010
01110111101101111010111011110111101101111010101111111100110011110101011011101111111111001010101111001
00100000101000010000001010000100001000001000000000000000000010000001000000100001000000000000000000001
11110101110111100110111101110101011110110111100010000011101011111110011111111011001111011111011110010
00000101000001000000000101000000000100010010000000000000000000000000000000001010000000000100000000010
00111111010010101111101101111110111110001011101011111011101101010111101110110001111111101111010011111
00000000000000000000100000010000000000001010000000010010000100000000000000100000000010000000010000000
01101101011101111111101010101110001111010111111001110111011100110011101111111001111101001101111101011
01000000000100001000000000000000000000000010000000010000001000000000000000100000000000000000010000000
10111101011111011110110011101110110100101111111100111011111111101100101100001001110110101111011111001
00000000001000010000000000100010100000000000000000100000000000000000000000000000100000000010000000001
11010110101111101111110110011011110111101011011011110111011101111010111101110111101101111011111110110
00000000000001000001000000000000000100000010010010000000010000000010000000100000100000010000100000000
01011011011001011110111100111100011111101110001100111111110110111110101101011110110101110111011111001
01001000000000000000010000000000000010000010000000000000010000001000000000000100000000000100000000000
