00000000000000100000000000000000100000000000100001000000010000000001010000000010000000001000000000000
11100111011011010110111110011111101010111001001111110011111110110101010111000110111111000101010111110
00000001000000000000001000000000000000000000000010000001000000000000000000000100100000000000000000000
11101111111100011000111110011000011010011011101110111011011011101011011111101001110111101101110111110
00000000000000000000000000000000001010000000000000000000010010000001000000000000100001000000010010000
10100001101111111011011011101110101010110011011111101100001111100011011101100100101111111000111011111
00000000000000000000000001000000000000000000000000000000000000000000000001000000000000001000000000000
10110110100110011011111110101101110110100111011001011110111100010111011100010111111110111101101101111
10100010000000000000000000000001000000100000000000000000000000000000001000000000001000010001000100000
10111011111010111010111001111110010111011111001100110111101101001101111010101110110111110101001011111
00010010000000010000000000010000000000010000000000000000000000000100000000000000010000000001000000000
01101011011101011000101101110111100101111101101101111110111111001110100011011111011111111100010111010
01001000000000001000000000000000000000000000000100001000010000000100000000000000000010000000000000000
11101111001011111110011101000111101101011111100111011101011101010011111111001000111110111110111111001
00000000000001000000000000000000001000000000000010000101001001010000000000000000000100010000100000000
11110111011010111010110111010111110110110111010111111000111100111010111100111111101100111110101111011
10000000000000100010100010000000010100100000000010000000000000010000000000000100000000001000000100000
11110011111011011010111101111100011111011011101111111010110011001110101001111111101101111011101101101
00000001000010000000000100000000000001001001001000000000000000001000100000000001001000010000100100100
00111111101011101111010111011010101111011011111110100100011111111001111010101110101110011010111110110
00000000100000000010000000001010000000000010000000000000000001000000000000101000000100000000000000000
01101000111101111110010101111110111010111110111010111000110011111111110110111111010011101101111101010
01000000000000001000000000000010000000000100000010000000000000000001000010000000000000001000000000000
01111011110101111011101110110101101101011100001110111111111011011111010111111110101001101011111011011
01000010000001000000001000000101000101000000000000000001000000001000010100000000000001000000001010000
01111110111110110011011110110111111001101101101110111111101000100110111011110111011101100101111101101
00100000100000000010001000000001000000000100000000000000000000000000001000010000000001000000000000000
01111101101011001010010111011110111101110011010110111101010111111101011101011101001011101111111101100
00010000000000000000000000000000010000000001010100000001010000010000000101000101000000000001000000000
10110011101110001001111110111101111011101101101011111011000111011111011100111101010111101110110100111
00100000000000000000000000010000010000001001001000001000000000000000010000000100000000000000000000000
10011111101011101101111100111011011110111101111001101101111001111110101001110111011111101010110111011
00000000000001000000100000001001001000010000000000000001000000100000000000000010000010000000000010000
10101110110111111000111110101111111101011111011100110111010110111110110001111101101111011011111011110
10101000100000000000010000100000100000000100000000010100000000000000000000100001000000000010000010000
01101111011100111011001011010110110111111010011101001111111101101110001111111111011101001111010011111
01000000000000000000001000000000000000000000010000000000100000001000000000010000010001000000000000000
01111100101110111110111011111101011111100111101011110110100110010011110110111110110100111111110110111
00000100000000000000000010000000010000000100001010000000000000000000000000001000000100000000100000001
11110111011011011011111111010110111001101111011101101111110110011100101110100111111110101111011111100
00000100000001000000010000010000000000000001000101000010000000000000000010000000001000000010000000000
11101011011010011101011111010101110101111010111011011010111101101010111010110001111010010111110111101
00000000001010000000000000000100100100100000001010010000000000000000000000000000000000000000000100000
01110111101110101001111011010110111001101111111010011101101111100111011110111010111001111011011010110
00010010000000000000001000000000000000000010000000000100100010000000000000100000000000010000000000010
11010110011011110111110101011010011111111011111100101111001111101101111111010100111100111111110011110
00010000000000000010000000001000000000010000000000100100000000100100000100000000000100000001000000000
11111100111111100111011110010101011010100010111101101011010111010111101111110111011111001010011011010
10000000010000000000000000000000000000000000000000001001000000000001000001000000000000000000000000010
10101001111111011101101111010111010110100011111001000101111011111001110110101111011101110111101010110
00100000000001001000000000000000000000000000000000000000001000000000000000001000001001000000000000000
11011110101001101111110101010010111110101111111101011011011001111100101110011111001101110101011100111
00000000100000000000000000000000000010000000010001010000000000000000000000001000000000000001000000000
01111101110101011101110011001010101111100111101011110101110101001111101110111010000110011111111111101
00000000100000000000000000000000000000000000100000000000000101000000000000100000000000000000001000001
11001011111110010110101011111100111110101011101110101111010111000111111100110110111101011101011010111
00000000000000000010000000000000000000000010000000100001010000000000000100000000000000000000000010000
11001101110111011011011001001111110111011011011100110011011110111110111010111111010011010110111110110
00000000000100010000000000000000000100000001010000000000000010001000010000000000000000010000000000000
11111100011101110111001111011101010001111111001101110010111110111101111101111110111000101011110111101
00000000000001000001000000000000000000000000000000100000000010000101000001000000000000000010000100000
10111101000111011111111100100101010110111111011011011011110111010111111011110010111011101110011110110
00000000000000000000000000000000010010001000000001010000010000000001000000000000100010001000000010010
01111001111011111101111000001111010011011111111001001010010000111111010111110111111010100110110111110
00000000001010000000000000000000000001010000000000000010000000000000000000000000000000000000100000000
10001111101110110001101110111111011111101000111011110111011110011010111111011110100010011111111100011
00000000000010000000000000000100001000000000001000010000000010000000000000000000000000000010000000000
10111101010111110111110001110101011110000111110111101011111101111001100010011101000101111110111101110
00010000000000000100000000010000000000000000000001001000000000000000000000000000000000000000010000000
10111101100011011101110010011111110111011110011001111110011101011111001101011111011110101011101101111
00000000000000000100000000000000000100000000010000000010000000000000000000001000000000000010000100000
10111011111101010111110001010111110111111100001001111110111100100111111010011110111110101001110001001
00001000100000010100000000000000010000000000000000000000000000000010000000000000000000000000000000000
11000111111011111010001110111101110111111010101010111110111111100111110101111011101000111111011011101
00000000001000001010000000000000000001000000100000000000010000000010000001000000000000000100000000001
11101001111010111101101100101110111111110010011101001111111111000110000111010001111111010111001010111
00000000000000100000000000000100001000000000001000000000000000000000000000000000000000000000001010000
10100110111001111101111001011011110111101110101110111100111011101110110111101101001110100100111111011
00100000000000000000000000010001000001000000000000100000001010000100000001000000000000000000000000000
10111011101101101010101011110111101101100111001101101111110111101101111110101101100111001011101111110
00010010000000000010000000000000100000000000000000000000100000000100010000000000000000000000000100000
10111101011000100111111101111111011011101110100011111101011101101101101011111010111111001111110110110
00100000000000000000000100000100001000000000000000000001001001000101000000000000010000000010000000100
11011111011110111111001101111010100100011110111101110111011100101011011011011111011001110110010111110
00000100000100100000000100000000000000000000000000100100000000000000001000000001000000000000000000000
10111101110110111101111001111011111100100110111011110111111010111110001111001111011101110110110101111
00100000000100000000100000001000000000000000010000010010000000010000000000000010000001000000100100000
10100011111111011001011111110011011011111011011110111001010110111111110011111111010101011110111101100
00000000000100010000000000000001001000000001000010010000000000000001000000001000000101000000000000000
10011110111100111011101111101001010111101011001001011101100111111010111011110110110111000111101110110
00000000010000001000000000000001000000101000000000000000000000000000000010000000100000000000000010010
00011111011111001010001011111111010001011111001111011101010111110111111011110111101100011100101101101
00000000000000000000000000000100000000000000000000001001000000100000100001000000000000000000000000000
01101111010001111111101111100001111011011111011110000111001111101101111010101111101110101011110111101
00100000010000000000101000000000001001010000000000000000000100000000100010100001000000000001000100001
11111001011101101111101001110011101111110011110110111110011101101010110101111110111111100110011111010
00000001000100000010000000000000000100000000100000010000000000101000000000000100001000000100000000010
11010111111100111101111110110011100111110100011011101110110111011010100111111001110011010110111101100
00000000100000000100100000000000000100000000000000000010000000001000000000000000000000000000000000000
11011111001101000010111111111010100111111010110101111111000111111011001001111110011101101110011111011
00010000000001000000000000001010000000000000010000000000000000000000000000100000010000000010000000000
