00000000000000000000000000000000100000000100000000100000000000000100100000000110000000000100000001100
10000001111111111011110110010101110110101101111111001011011011010111111101101011011111101010101101111
00000000000000001010000000000000000000000000100000000010010010010000010000000001010000000010000000000
01111111100010011111100011111101101111101001001111100101111110101001110001010101101110101111100111110
00100000000010000000100000000000100000000000000000000000001000000000000000000000000000000000000000010
11010100111001111110011101111111001110111011111011110110011001110101101111011111001110111011101111011
10000000000000000010000000000000001000100001000001000000000000000000000010000010000000001000000001000
11101011011011011100111011000110111101110111111010110010011101110101001110100100011011101011100111111
00000000000000010000000000000000000100100000000000000000000000000000000010100000000000000000000000000
11110011011111101011100010011110111101001011111011011011011110110111011111010110101110111101000111111
00000000001000000000000000000000000000001000010000000000001000100000001000000010000000000001000000000
10110111101110101111001110101001011110111100010110110110011011111111011101010111010100111011100101110
00000001001000100000000000000000000010000100000000000000000000000000000000000000000000100000000000100
11011110111001001111011101110111010111010110000111101110110111001011111000011011111011110111111010101
00000000100000000000000101000000000000000000000000100000010001000000000000000000000000100001000000000
01110101101111101110101101000101011011011101010011101110111111011011111100010110011110111111011110011
00000000000000000000000000000000000000000000000000100000001000010010000000000000000100000100010000000
11001111100111111011000101111101011011100111111110110100111011101100111111101100011111110111011111100
00000000000100000000000100100000001000000000010000000100000000000000000010000000000001000001010000000
10111011011011110110010111011111101011111110011000100100111011011101111100101111011011011111010101111
00000010010000000100000000000000000000000000000000000000001001010001000000101000010010000000000100000
01111110001111100101100110011111101110101111011001111111101111111010110000011100111011101010111011001
01000000000000000001000000000001001000000001010000001000001000000000000000000000000000000000000000000
10011101101111011011111111111010000001110101101101111011110011110110111111110100011010111010111101110
00000000000001000000000000000000000000000000100000001001000000000000010000000000001010001000000000000
11010011110111011111011011001101010011111111101101101111011010011111101011110110111101101101110011110
00010000000001000000001001000000000000000001000101000000010000000000100000000000010000100000000000000
01101100110111110010000011111111011111111011010011110101101101110110111101101111101111111000111010111
00100000000000010000000000000000000000100000000000000001001000000100000000100000100010000000001000000
11101101110110111110101101111011101110111011101101011010101111010111101011111101111101000101011001111
00000001000000100000001000001000100000010000100000000000000000000000001001000001000000000000000000000
10111101101110011011111110011101011101010111111111001110011101101010111001111100011101110111101101111
00100000100000000000001000000000000101000000010000000000000000001000000000000000000000000100000100000
10110110011110011101110111111101100111101100101010011101110011110111111011101111001111111101111101011
00010100000000000101000001000000000000000000000000000000000010000010000010000100000000100000100000000
10110101111100101111101110111100001111111001011011000111100110110100011110110101101110010111011010111
10100000000100000000000000000000000000000000000000000100000000000000000000000000000000000001000000000
00111110101101110010111111110010101011001111011111011111010010110100011111111101101111000011110111110
00000000000000000000010000000000000000000010001000001000000000000000000000001000000000000000010010000
11100111101010111110110110101101111100101101111101111101011011100110111111001101011100111111010001011
00000000101000000100000010100100001000000000000101000001010001000000000000000001000000000000000000000
10111011101000111111111111100110101011100111110101110100111010111101110011110101111011101101111010110
00100000100000000000001000000000000000000010000100100000000000000100000000010000001000100100001010010
11110100101110111101101110010110010011111111100101111000111111010010110010111011111001111101101011011
00000000000100000000000000010010000000000000000100001000000000000000000000000000000000000000000010000
11001111011011101110111111101001111110100111011101011011001111101000111100001111110111111010111111001
00000010000001000000001000001000000000000001001001001010000000000000000000000000010010000010000000000
10101110110010111110010001110110110111100001111010111111011110101110111101101111110110110101101111101
00000000000000000000000000000000000000100000000000000001000010000000000100000001000100100100100000000
11011100111111100110111101110111001111011110110101101111011001110111101111000101101111111111010110111
00000100000001000000000000100000000010001000000000100000010000000001000010000000000000001000010010001
11011011101111101011101101110111010111010011100101111011101111110101001111100011111011111110111100100
00000000100000001010000100000000010000000000000000000001000001000000000000000000010000100000000000000
01110010010111111100010110111010111011111101100101010110110100111011110101011111011001111011111110010
00000000000000000000000000000000001000000000000000010010010100000000000000000100000000000010000000000
11011011110110111110111001010111001110110110110111101110111011011110110111111110101111010101110101111
00001010000100000000000001010000000000010000000000000100010010000010100000100000100001000000000000000
10101110011011010111110100111100011101110101101100101001110100011111011110111001010100100111011111111
00000000000000000000100000000000000000000000000000000000000000000000000000010000000000000000000000001
01101101111010101011010110110011101110111001101101101110111011011011101101111110110100101011111101111
00100100001010000000000000000000000000000000101000000000100000000010001000001000000100000000000100000
10111101101101011110101011001011111110110101001111010101111110111011101111011011010111011111101101100
00001000000101000000101000000000000000000000000000000100000100000001000001010001010100001000000000000
01111110110111111101010011001111101000111110110111110001110011111001011010111011100111111110110100111
00001000010000000000000000000010000000000010100000000000000001000000000000000000100000001000000000000
11001111110111101010110111101011110101110111000110101010111110110110111000111111111001011111001001111
00000010000000000000100001000000010101000000000000000000000000100000010000000001000000000100000000000
10110101111101101110110110111100110000011101111110101011111011111111100111001011110111111001110111110
00100100001001000000000010001000000000000000000000000000001000001000000000001000100001000000010000000
01110111101111001111101111001011110111011000111101111001011110001111101110110111101011111011111100110
00100010000100000010001000000000000100010000000000010000000000000000000100010000100000000010000000100
01101101011101111001110111101111110100001101010010101110011111101110001000100110011111111100101111110
00101001000000010000000000000000000000000000000000000000000000001000000000000000000000000000000000010
11101111101101111011010110010111110111101100110010101101111111111010001101010101110101000100111111101
00001000000001000001010000000000000000000000010000000000000000000000000000000000000000000000000000100
01111011011100111101111101111110100101100110111101011011110111101011110111011111100111110111001001110
00000010010000001000010000000000000100000000000000000000100001000000000000010000000100000000000000000
11110101101111111101010101111101011111001011111101101011101111010101111000110101111001111111011101100
00000001000001000000000100000000010000001000010000000000001000000000000000010000000000001000000000000
10111111111100101111010101001111111111011001101110011111111111111010000010110111011101101001101101111
10000010000000001000000000000000100000000000001000000001000000000000000010010010000101000000000000000
01111111101011010111101100101111101110011101111011110011011111000101111110010110111110100111011011101
00000100000000000001000000000001000000000000100000000000010000000000000100000000000010100000000000000
01111110010111110101111100111001111101101110111101110101111011110111101101101101001111111011001010110
00100000010001000000100000001000000100000000010000000000100001000100000000001000000000000000000000000
10111011101100101101110101111101101001101011110101111011011101111101010110011110111110101111010101111
00000010000100000000000000000000000000101000100000000000010000100000010100000010001000000000000100000
10100111011111011111110110110110100111110101110101101011110010101111110111101100101111011111111010110
10000000000001000010000000100100100000000000000000100000000000000000010000000000000010000100000000100
00111110101111110111101010111101100100111011011100011111011011100111001111011110101110110001101101111
00000010100001000010000000000000000100000000000000000000000001000000000001000010100100000000000000000
11111001110111011100110111100111011110101111101011011010111110111101011111000111111110101100110000110
00000000100000010000000001000000000100100010001001010000000000100000010000000000000000000000000000010
11011101111100101111101101111011100011001110101110011101111110111010110010001101111011100111111001011
00000100000000000001000000000000000000000010101000000000000000000000000000000101000010000000000001000
01101101101110011011010110100011110110111111011101011101110110101111110111010111110110111111100001110
01001000000000000000010000000000000000000100000000010000010000000000100001010000100000000000000000000
11110001111010111110111011011010010011001101000111111111001111111011111111001001101101111101011111101
10000000000000000000000000000000000000000101000000000010000000010000000000000001000100000100000001000
10101110011100111001111101111110000111110111000001011011101110111101011011101110111101111111011011101
00000000000000000000010000010000000000010000000000000000000000000000000000001000001000001000010010000
