00000000001000000000000000010000010000010000011000000000000000000101000000000000000000001000100000000
01101001001111001110111101110111101101111111110011011111011111011011000011101111110100111001101111101
00000000000000000000000000100000001000010000000010001000001000000000000000000010000000001000000000001
10110101110111011101101110110111101011111011111000011010111111011111011101101111101001100010111111101
00100000000001010000100100100000100000001000000000000000000001000000010000100000000000100000000000000
11010111100011101111001110111111111001101101011110100111111101011101011101110101111000010111010111101
00000000000000000000000100000100000000000001000100000000000001000000000000000000000000000001000000000
10111010111011010001111111110111011110001110101101010101001101101011111111011111010010101111111010110
00000000000000010000000000000100000000000000000001010000000000000000000010000100010000000000000000000
01111000011001011101101101111111101111001011111011110101110111111001011011011110111111010101110101111
00000000000000000000000000000100001000000000100001000100000000000000000010000100100000000100100000000
11101011111001111110110001010101111010111101111010011100101111001101011110111100101011010111010111011
10001000000000000000000001010000000000000000000000000000100010000000000000010000000000000000000000000
01101111011101101011000110111111101011011111001110001100011101111100010011111111011011111010011110111
00000000010000000000000000000010000000000100000000000000000000000000000000000000000010000000000100001
00111111011011110011101101111011110101011101100101110101111110110111111001101111011011110110111011110
00000001010010000001000000100000100101000000100000000000000000100001000000000000010000000100010000000
10111010101111110111101111110111111010001101111011111010001001101111101011101101111100010100100111110
10000000000000100100000100000100000000000000000000000000000000000100000000000000000000000000000000000
11010010111110111101101101101111101011101000111110101101111110101110110101110110000101110010101111110
00000000000100000100000000000100000000000000000000101000001000000000000000000000000000000000000000010
11101011101111101001111110110110101111101110110111111110111100110111011111111110011011011010101111110
00000001000001000000000000010010000000100010000000010000100000000001000001000000000000000000100100000
01111001111001101001110110110111111011101100110101101101110111001111011110100111111110011111100111101
01000000000000000000010010000000100000000000000001001000100000000000001000100000001000000010000000000
10110110111101110111011101111100111110101111100111100100110111101011111110011101101001111111101101011
00010000000100000000001000000000100000001000000000000000010000100000000000010000100000000000001000000
01111101111110010010011101111011101110111111100101000111101011110110111111011101101001111001011111101
00001000000000000000000000001010001000010000000000000000000000000100000100000000100000000000000000000
01111001011101111111111100001011010111101110111110011101101011110111101111101011110101011101111110001
00010000000000010000000000001001000000000010000000000001001010000010001000001000100000000000000000000
10101110110110111101011111100111100111011110011110010101010111101011111001110111101101101111101110101
00000000000100000100000001000000000001001000000000000000000000100000000000000100000000100000101000000
11101110110110111101111111101100100111001110110101010100111111011011101110111001110110100011111011010
00000000100000000001000000000000000100000000000000000000000001001000100010000000000000000000000000010
11101100001111101101101110111100111011101111110110101101101111100111011010011010011110111101011110000
00000000000000101001001000000000010001000010000010101000000100000000000000000000000000000000000000000
10100011111110111111000101101111011011011011101110111101100001110101001111111101001011110101101110110
00100000000000001000000000000000000010001001000010000000000000000000000000000000000000100100000010100
11110110001011100111101101110111101011100110100111010101011111101001111101110111110110100110101111110
00000000000000000000100100010000000000100000000000000000000000000000000100000000000000000100000001000
11010111011110111011101011010101110110111001110100101011110100011111010101101111110010111001111011011
00000000001000000001001000000000000000000000000000000000000000000000010100000000000000100000010000000
01110110111111110001101111010011101101111101111010101101111101101111110010101110111110111111010110111
00000000001000000000100000000000100100100000000000001000000001001000000000000100100000100000000100001
10111101001011101101011011011110100111010011101101110101011100111101110010010111111011101101010111101
00000000000000000100000000000000100000000000000000000000000000000000000000000000100000000101010001000
11011011101010110111101000111111111111001011100100001111010101001111101011111011011010111110110110111
00000000000010010100001000000000100000000000000000000000000000000000000000010001010000000000100000000
11011110101110010110110111000110100111101111100111101110100111110010111111101111110101110110001101111
00010000000000000010000001000000000000000000000000000000100000010000000000100000100000000000000000001
01101100100111001111111010101111110010100110011111101101111101111111010111101110101110011100111011011
00000000000000000000000000000100000000000000000000100000001000001000010100000000001000000000000000000
11110101110111111101011110010011111111110010011010111011111011101011110111011101111011111011111010000
00000100000001000000001000000000000100000000000000001000001001000000010100010000100010000000000000000
10111001011100110111110010101001101111001111101111010011111010110110011100110011111010111110010101101
00000000000000000000000010000000000000000000001000000000000000000000010000000000000000100000000000100
10111011111011111010000111110111011101100101111101111010011011110101111101011101011011110011100011011
00001000010000000000000000100000000000000000010000000000001000010000000101000000000000000000000000000
00111101011011110011110101111011101000111011111010111011111101100110011011111101101001001110110111101
00000000000000000000000100100000001000000000000000010001000000000000000000100000000000000000000010000
10110001110111101101111110101111100111111010011101111101110111011110001100110011111111001011111110101
00010000000000000000100000100000000010000000000100000101000100000000000100000000000100000000010000000
11011111011111001100111101110111011101010111111001100111011100111101111101101011010110111011011111101
00000100001000000000000000100000000001010010000000000000010000001000010000000000000000000010000100000
11011101111010111010111011010100011111110110011100111101110110110101001111101111100101111110111101001
00000000100000000000000000000000000100000100000000000000000000000000000010000100000000010000000000001
00011111111110101101101001111101110101101011011110101011110101011000111110101011011110111011101110111
00000000001000000000100000000000000000000010010000001010000000000000000000000001000100100001000100000
10011111011100111111100111011101101111011101011011011101111001111011010110111111101011011111110011010
00000000000000100000000100000000001000000001000000000001000000001010010100001000000001000000000000000
01111101011111101011011101010001111111100111011101110111110101111011111110011100110100111001111101110
00010000000100000010000000000000000010000000001000000001000000100001000000000000000000010000000001000
11011010110111101011110111101101111111010010111010110110110111010110101011011011100110110101001111110
00000000000100000000100000000100000000000010010000000000000000000000001001000000000000000000000000010
11100101101101100101110111011101011011111111000110101111011110101101110101111011101101111011110111011
00000000000101000000000001001000000000000000000100100100000000100000000000001001000000010010000100000
11101110101110111001111110101111100111011010111001011101010111101111101101011011110101111100111011101
00000000001000100000010000100100000000000010000000000000000000100010001000000000100100000000010000100
01101100111110110110101011101101011111111111001101111011101110011011101011100101111111111000101011011
00000000000000000000001001000100000000100000000100001010000000001010001001000000000100000000000000000
11101111011101011100111101110111011000111101100111001111001111110111101011100100111001101111011011101
00000100010000000000010000000000000000010000000000000001000000000010000000000000000000000000001000100
01101111111101110101110010101100101111111001101101100101101111011111010011001001111010010101011011111
00000000100000000001000000000000000000000000000001000000000000000000000000000000010010000000000000000
11101110111101011011111000111101110000110011111111111010110111000011001011111111011100110011111011101
10000000010001000000000000001000100000000000000001000000000010000000000000000000000000010000000000000
10101111011111110111001111001110111101100111011101101111001110111110111010011111011001011101111101010
00000010000100000100000000000100000000000100001000000000000100000100000000000100000000000100000000000
11001110111111001101111111110001101010010111101101101111101101010111011111011011001111110010001111110
00000000010000000001000000000000000000010001000000100100000000010001000000001010000000000000000000100
11011101111101001111011101011010100111011110111011011110111101110111101101000111011011111011011110101
00010000000000001000000000000000100000000000001001000010100000100000000000000001010001000010001000000
10110110101011111111011011111011111110011100100010111111011111001110100100011100111110011111101101101
00010000000000001000001000000001000000000000100000000000000000000000000100000000000000000001000101000
10111111010101101011110111010110011110101001101111011011010111101111110100110011110110111010100111110
00000100010100000000000000000000010000000000000010001001000000101000000000000000000100000000000000000
10111111001110110111011110110111011101111111011011111001001110111111110001011110101111111010110101111
00010000000010000000000100000001000000010000010000100000000000000010000000000010000000000000100000000
01001111011101110111001111100111000110110101101011100100111111111100111011110110101110100110111111011
01000000000101000001000000000000000000000000000000000000000001000000010000000100101000000000000010000
