00000000000000000000000000000100100001000000110000010000010000000000000000100000000000100000000101000
01111101011101110110111011011101011111011110001001011111011011100011111011011110111011001011100101111
00000000000001000010001001000101010000000000000000000010000001000000000001010000000000000010000000000
01001011101011111110010111101101011111100111001111110110110101111110111011111100011011101111011011011
01000000000000001000000000000001000010000001000000010100000000001000010010000000000010000000010000000
11111000100011101111011110111001111111111001001101111010001011001101111100111111011110010111111011001
00000000000000000001001000000000010000000000000000000000000001000000000000001000010000000000000000001
11011011111001101001110011111011111000110010111111011010111001101011111110001011100111011000110110111
00000010000000000000000000010000000000000000000100000010001000000000000000000000000000000000000000000
10110100111111111100011110111110011011110000111111101110110001110111100011100111111101101110011111011
00010100000010000000001000100000000001000000000000101000000000000000100000000000000000100100000000001
11000111010111110101111010101011111101011101111101110111111101011111100010111101111101010110101011110
00000000000000000101000010100000000000001000010000100001000000010000000000000101000001010000000000010
10111111010101001111111111010111011011011101100011010111111100111101100101110111011011111010101111011
00010000000001000000010000010000000000000001000000000000000100000000000000000001010001000010100001000
11011010001010010110111111111101110111010111111100011010110011101110110111101101010010110011101111011
00000000000000000000000000001000000000000100000000001000000000000000000010000000000000000000000000000
01111111011111011111101101110110011101101110111110100101110101111110101010111111011011111101010110110
00000100001000001000000001000000000000000100000000000101000000010000101000000001000000000000010100100
11011111010110111100100111110111110101111111001110100111000001011010111111011001011010111110010011111
00000100010000000000000000100000000100000000000000000000000000000000000000000000001010001000000000000
11001111110101111011101011110110111011111010111010011111101110101011100011101101111110001110111101101
00000000100100100000001010000000010000010010001000000000100000000000100000000000000000000010001000101
01001011010111111001111100111111010011100111111000101101111010111101111011111010101111010111001101111
00000000000000000000001000000010010000000000000000000000000000010000100010000010000000000010000000000
11101011011011001001111111101101101011101011111110110100100101110111101110111111000010011001101111111
00000000000000000000000100000100101000000000000000000000000000100001000010000000000000000000000000000
10111110011011100101101011110110110101111101111100100010101101111000111101010111011011011110111101011
00000000000000000100100000000000010000000000000000000000000000001000000000000000000000000010100000000
00111110111110111010110111101101101001101110111001111100111111111101100100100011111011001011111111011
00000000010000000010000000100100000000000000000000000000010000000000000000000000100001000000000010000
01111010110110111101001111101011101101101101101110011101110110111010111110111010110110111100101111010
00000000000100010000000001000000000000000001000000000000010010001000000100100010000000000000000000010
01010001111111101011111011111111010101011011111011101110100011110110110001110111111101110111100111110
01010000000001000000001000010000000000000001000000000000000001000100010000000000010001000010000000000
11011011011110011111101011111001100111111010110100111111101011110111111010110111110011110110110111101
00001001000000000010000000100000000000010010100000000001000000000010000010000000000010000010010000100
11001110011001111110111011001101101101101101100111110111101011011011011110111100110110011011111011100
00000000000000000010000000000000000101000000000000100000000000001001000000000000000000000010000000000
11101111011010110101100001010111111111100011111101101111100001011100001111111111101110101110110111101
00001000000000000100100000000000000000000000010000000100000000000000000000000000001000000000100000000
10110100101111111100100100111011111101111110101011110111110101110100111111110010100110111111101011101
10010000000000000000100000000000000000010000001000000001000000100000000010000000000000000100000000100
10101101111111101101110111011101110110111010001010101111111011010111111101110110001110110101101011111
00000000001000001000100010001000010000000000000000000000000010010000100000000000000000000000100000001
01001111101011011110111001111110011110111001111011101111101001101111111011101101101101101011111101011
01000000100000000010010000000010000000000000001000000000000000100001000010000000101000000000010000000
11101111100101011111001011101111010111111100111110110111010101111010010101111011101101101100111111010
00000000000001000100000000000010000000010000001000000000000000000000000001000010000000100000000000010
11101010110111011100111101011001111111111110010101010110100111110110011101111000101011101111011110011
00000010000000001000000000000000001000000000000000000000000010000000000000000000000001000000001000000
01110011101111110011111010111111010111010111111110110011011001110111111010111010011110100110111110011
01000000000100000001000010000000010001010000010000000000010000000000100010000000000000000000000000000
01101011011101111011010100111111110001101011010101111110101101111100111110001110111011111110101101000
00000000000000100000010100000000000000100000000000000010000000001000000000000000000010000000000000000
00011011111110111011110110111101011110100111111111010001001111110110110011110111011100111100101101101
00000000000000010000000100000000000000000100000000000001000000100000000000100100000000000000000000001
01001100011011111111011110011101101011111101100101111101110110100111101111111111100001101101011000110
01000000000000000001000000000000001000001000000000000000100000000000101000000000000000000000000000100
10001000111111111101000111110110111011101111010111101111100011010101111010110101111011100010101101111
00000000000000000000000000010100010000100010000000101000000000000000000000000000000000000000001000001
10111011100111111111110010110101011010111101110101110111111001111010101001110111111001111100011011011
00100000100000001000000000100000000000000000000100010010000000000000000000010100000001000000000000000
11011001111111001110111110101111110110111011001111101010110111111011101010101000111011110111101011110
00010000001000000000010000000010000100100000000001000000000001000000000000100000000000000000000010000
01011110111110110101100111110110101110011111100101100110011111001101011011011110110011111110101111011
00000000001000000000000000100010000000000010000000000000000000000000000000000010010000001000000001000
00110001111101100110010100110111111111110111100111101111010110111111010101100101110101110101110111011
00000000000000000000000000000000000001000100000000001000000010100000000000000101000000000000010000000
11011111001111010101011111001111101110011110101101101111011110101101110111110111011011000011111011111
10000000000000000001000000000010001000000000000100000010000000100000000001000100000001000000000000001
10111101010011110111111000111110101100111111011010101101011100111110111011001111101111101100111010111
00100001000000000001000000000010100100000000000000101001000000000010010000000000100001000100000000000
01111101101100111111010101100111111010111011101111010111111011101111010111011111100001111011110111011
01000001000000000100000000000000000010100001000010000000100000000100000000000000000000100000100100000
11101111111001101000011010111011110111010111101111011100111111101100110011010110111110111101010011111
00000000000000000000000000010000100001010010000100000000010000000000000000000000010000100001000000000
01111110011111001011100110111101110100111001011010100110111101110110111010111101110111011111111001110
00010000000000000000000000000000000000000000000000000010000000000000100000000100010000000010000000010
10001111101101110110110111011011111100111110101011011110111110101101101100111101110110111110111110110
00000000000100010010000001000000001000000000000001000000100000001001001000000000000010000000100000000
01110010111011101011111011100111111111001110000110111110110001111011011111011110110001111111110001110
01000000000000101000000001000000100000001000000000000000000000000000001000010000000000010000000000000
01110111011110110010101101111111111101101000010100110100101111110011111101101110001110111101011111100
00010000000000100000000000000000000000000000000000000000000000000001000000000000000100000001010000000
10111100100111001110101111101110010110110111011101111100011111110011011111011101001110111111010101100
00100000000000000000000001000000000000000001000000000000001000000010000100001001000000000000000000000
11110110101011001111110111101001110100111101111010111110111101101110010111111011110011100111101011011
00000000101000000000010100000000000000001000010010000010000000001000000000010000100000000000101000000
11011011010111110101111011111110001110001110111101111101011101101111001111111011110111100001111101011
00000000010001000000010000000000000000000000010000010000000000100001000000001000000100000000000000000
11011100011110100111011111010101111110101110111100111010110110111101011111101111100011111110001011110
00000000000010100000000000000100010000000100000000000010010100010001000100000000000010000000001000000
11010111101011101110111110010110001101110101101110111101101100100011111011111001111101101110010101110
00000000000010000100001000000000000000000000000000001000000000000000000000010000000000000000000101000
00111110011110111001010111111010101111111101011111011010111010011111011100110100111101111101110110110
00000000000000000001010001000010000001000001001000000010100000000001000000000000000000010000000000000
10101111001111001111011001101111001101011011101111000001110111100010101110001101001111111101111010111
00000000000100000000000000000000000000001010000000000000000000000000000000000000000000000000000010000
11000110111101111101011010101111010010011111010110011100110111001011101111011110111110111110101101111
00000000000100000000000000000000000000000010000000000000000000000000000000001000001000001000100000000
