00000000000001100000000000000000100001000001100000000000000000000000000001000000001000000100000000010
01110110110111011001111110111011101011010111011101110111011101111110100010110110110100010101111011110
00100000000001010000000000100000100000000000000001000000000000000000000000000000000000000000100000000
11110101010011011110111011011110111111001010111011011111101001101111100011100111101110011110101110110
00000000000000001000100000000100000000001010001010010000000001000000000000000000000000010000000000000
11010111111110001111111011100011100111100101101100110011001101101111001101011111101111111101011011010
00000001000000000100000000000001000000000000000000000000000000000000000000000000100000100000001010010
01110011111011011111011110001101111101010111101101111011110011111010101011110110111111110100110110100
00000000010000000010000000000000000000010000100000000010000000000000101010000000100000000000000000000
11101110110000111111111010111100111101101110110111110111001101111001110011110101111011101101101101101
00000100100000000000010000000000001000000010100010000000001000000000000001000100001010000000001000100
10110111010101101111010111110000111111111010011110110101101110111101110011011110010111101110111100111
00000000000100000001000000000000000010000000000000100000000010100000000001000000000000001000010000000
00111111101110011010110110101101101111011011010100101110111101011000110110110111101011010111011111110
00000001000000000000000000000100000000000000000000000000000000000000000100010000001010000000000100000
01110101111100011110110111101111010101111001011111101011111110001110111011010111010100111111010101111
00000000000000000010100000100100000000000000000100000010000000000000100010010001010100000001000000000
01111101010111110110111110110011110101111101011101111010101010111011111011011011101011011101110111110
00000001000000100010100000100000000000100001000000000000001010000000010010010001000000000000100000000
01111110110111111011110110110111101111010111100011011101111010010100011001111110101000111101001111011
00000000100001000001000010100000000000000000000000000000000000000000010000000000000000000101000000000
11011111011001110111011111001111110011001111010100110001111101101010110111010111101111111010110001011
00000000000001000001000010000000000000000010000000000000000000000000000000000000100000000000000000000
10111110111011011111110111010110110111110011100111111111010101111011110111010011111101100010111110001
00000100001010000010000100000000000001000000100000000100000000010000100000000000000000000000000000000
11011001110111111010101000011101111111111110011000110111101011101111010111111010101101111011010110111
10001000000000000000000000000000001000000000000000100000101010001000000001000010000000000000000010000
11111100000111101110110111101111010111111101001010110111111001011111001001110111110110101111010101111
00000000000000000000100000000100000000000000000010000001000000000000000000000010000100100001000000000
10111010001101111101011010111101011111001111100011111010111001011111111001110010101111111001110111110
00100000000000000000000010000100000000000000000001000000010000000000000000000010000000010000000000100
11111010011001110111011011110011101011011010111100010001111111110101011010111011111011101011011011101
00000000000000010001001000000000000001001010000000000000000000000100000000000000010000000000001000000
10110111010110110010111001101110011101111011101011011101110110110011011101111000011000111111101111101
00000001010100010000000000000000000000000010000000000001000010000000000000000000000000000000100000000
01011111111101000101010111111110011101111011001101111011001111101011011011110100011111001011111100101
01000000000000000001000000001000000000100000000000000000001000000010010000000000000000000001000000100
11010100110111011111011100111111000111110011011101111101101101011010111101010111010111101011111010110
10010000000000000000010000001000000000000001001000001000000000000000010001010100000001000000000000000
01011001110111111010000101010111011100111011101101111110011100110110110100011110110101111011111100011
01000000000000000000000000000000000000000001000101000000000000000000000000000000000100001010000000000
01111001110111101101101011101111010111111110101110010110101101111111111010010111101010101111110100001
00001000000000000100100000000010010000010000100000000000000000000100000000000000000000000000000000000
10001111110110111101100101100110111010110111101111110011110101100111111101011100111001111010111001111
00000000000100000000000000000000000000000100000100000000000001000000000000000000100000001000000000000
11110110111100011110101111011101011101111011110111110110111000111110111011101101101111110001111011110
00000100000000000010100000000101010000010000010001000000000000001000010000000000000100000000000001000
01110110111001011010111110101100111111101111001001101111011011110011101010111111101111011111011101111
01000000000000000010001000000000001000000000000001000001010000000000001000000001000010000100000100000
11110100101110111011001111101110101011101110010110101111011001100100111111111011110101010101011101110
00000000000100000010000000000000000010001000000000000001000000000000000000010000000000010101001000010
10011011110010011011011011101110111110111101100111011011110111011111111100011011110110010111110111101
10000000000000000000000000000010000000100000000001000000000010000010000000001010000000000000100010000
11010010110111101111111110101111111000101011100111101101011110000111011111011101001111111011011011110
00000000000000100000100000001000000000000001000000000001000010000000000000000000000001000000001010000
01111111101101010011110110111001111101111110110111001111110101111001111101011110111011011111110100101
00000100000000000000010100000000001000010000000100000000000001000000010001001000001010000100000000000
11111010111011101110100111011110011110101111111010000111101110011110111011011111000111011110101111011
10000010001000000010100000000000000000000100000000000000100000000000001000000100000000000000100000000
11110101011111001110101101111110011010000111110110010111011111010011011111110101011110100111100101111
00000000010000000100000000000000010010000000000000000000000001010000000000100101010000100000000000000
01111110111101110010111111010101011011001111011101111010111111010110101111110011111111001110110111100
00001000000001000000000000000100000000000000000100001010000000010100100000100000001000000000000000000
10110110011011111011101111010111101001111111010101101011001111011101111101111100101011110111111010101
00000000000000100010000000010100001000000000000000001010000000001000000001000000000000010000000000000
01111101001101111110011111111000111101111001101111101101001110110001111111011010111101111110100010111
01000001000000000000000100000000010000000000100100000001000000000000000010010010000101000000000000000
01110111110111010101110110110110110111100001111101111110110110111010010111011101110101001011011100111
00000001000000000000100100100010100000000000000000100000000100000000000000001000000000000000000000000
11101101111011001101110111101101001011011110011100111111010011101111100101110110111101011111011110111
00000100010000000000000010000001000000000000000000000000000001001000000100100010000100000010000100000
01101010011111111001001110101110011110101100111101110001100111011011011101111101011011110110111100111
01000000000001000000000000000000000000000000010000000000000000000001001000000001001000000010001000000
10101111100111110011000111100111010110110000111111011101111111001101111000011110011111011111110011011
00101000000000000000000000000000000000000000000100000000100000001000010000000000000000000010000000000
11011110111110011011111001111100111100101111101111011100011001110100111110111111111011010010011111101
10000010010000001010000000010000001000000000000010000000000000000000000000001000000000000010000000000
10111011110100111101111110011111111111011000101001111110101101011111100101101001111110110011001111110
10000000000000001000010000000100000000000000000000100000100000000010000000000000000000000001000000000
01111000011100010111011110111101000011111011111101000011111100011101101000111011011111011010111011101
01000000000000000000000000000000000000000000000000000000000000010000000000000000000100010000000000000
11111010010010001101111110101011101110110101111101111101001011100001011100101100111101011110011101111
00000000000000000000000000000000000000100000010000000000000010000000000000000000000000000000000000000
11101011010110111110110110101101011101111001111101110101101111101101110001011110100010101111000111101
00000000000000010000000000000001000000100000001000000101000000000000000000000000000000000000000000000
01111111001110111111110011111110100110111100100110101110000100111111011110111110001110111011110110100
00001000000010001000000001000000000000100000000000000000000000000000000000000000000010000000000000000
00110101010110111101111010110110110000110110111111101011011010010111101111011111100110111011110001011
00000000000000000000001010100010100000000000000000000000000010000000000010000010000000000000000000000
01110011100110111111001110111110111001111110111101010111011010111101101111010111110111011011011100111
00000000000000000000001000010000010000000000100000000000010000000100000001010001000000010001000000000
11011101011110110101111101111110110001101011101011111110100110011011111101101100011111011110110101111
00010000000100000000010001000000000001001000000000010000000000000000001001000000000001001000010000000
01011111101111100111011010010111011111011011010010111110010111111101110111001110101111010101011111010
00000001001000000000000000000010000100000000010000000000000000010000000000001000000000000001000100010
11011101101010101111001111011011100111101100011010111111011100101111011101101011111001110110111100110
00000000101010000000000000000000000010000000000000000010010000000001001000000000010000000000000000000
01110111010101011111101011110111011101011111111000111011100111010010110111010111001111001111101010101
00010100010101000000000010000100000001000010000000000010000000000000000000000000000000000100000000000
10101101101111011100101011111011001111101101101111110001101111110110001101111111011010011110110111110
00000000000010000000000000010000000001001001001000000000100000000100000000000000000000000100000010000
