00000000000000100000010000000000101000000001000000000000000001010000001000100000000001000000100000000
01110111101111010011101110101101101000101110111011101110101101111110111110011101111101011011111001110
00100100000000000001000000000000000000000000001010000000100000000100100000000100001001010010000000000
11100101111001110111110110111011111110101111011101111011100101111101010110110101101110100111110110101
00000000000000000100000100010001000000001000010000000000000100000000000100100000000000100000000000000
10010111111011111001011001111011110010110111101011101011100111010110110111111011101110101111101110110
00000000000001000000000000000000000010010100001010000000000000010000000000100001001000000001000000010
01010010011111111111001110110111001110111010111111011100111110101011111110110010110111111001011010111
01000000000000000000001000100010000000001010000000010000000000001000100000100000000000000001010000000
11011011110101011111101111100101010111110011111110111101101011111101011011101001101111101100111110111
00001010000100000000100000000000000001000000001000100000100000000000010000100000000000100000000010000
10111001111101101111010111101000011110111101110111111000111000111111110101111001101110110110111110101
00100000000101000000010100000000000000000000100000000000010000000000000100100000000000000100100000000
01110111101110010111111011100101110111110011111010110011101111011111111000101110100101111110011101011
00000000100010000000000000000000010001000000010000000000000001010000000000000000000000010000000101000
10111100101101001101011100001110011111000101111110101111100011111111011110110101011101110101100111110
00000000000000000000000000000000000000000000000000000001000000000010010000000001010001000000000000100
11110011110000010001110011111101001110101011111101101110101111011100111001111000101110110011101110111
00000000000000000000000000000000000000000000000001000010100000000000000000000000000000000001000010000
10110110111001010011111111001111101001110011010111110001111111101111110101000111010111011101111111001
00000010000000000000000010000000001000000000000000010000000000100000000000000000000010000000010000000
10100111111011111111000011100101111111001111001110111100110111010111010110111011111011011001101101111
00100000000010000000000000000100000100000000000100000000000010010010000000000000100000010000000000000
10111100100011111101111011110111101011110011010111110111010101111001000101011011111001100101111011101
00010000000000000000001001000100000000000010010010000000000101000000000000000000000000000000000000101
11101000111111111001001100011111001111110110110111111100001101011101011110110011011110011010100111111
00001000000000000000000000000000000000100000000001000000000000000000000000010000000000000000000000001
01111101101111010101111101101010111111111100110001010111111101110111010111110100111011011100011110011
00000001000001000000000000000000001000000000000001000000010000000010000000000000000010000000000000000
10010011101111110010101100111110101111011110110011111111011001001100111111101110011001111011110011110
00000000000000000000000000000000001000010000010000000000000001000000000001000000000000001010000000000
11100111010111011011110111011010110011111100111111111011111110111100100011111111000010111110111101011
00000000010000001010000010000000000000010000000010000010000000000000000001000000000000001000000001000
11110010110110110110110011111101111101011100110111110001001111001001101101111101011001011111101011110
00000000010100000000010000001000100000000000000100000000000000000000000000000000000000000001000000000
01111101101110101111011101111100101111010101111110110101011111001111110111111010010001111110110111101
00000101000000000100000100000000000000010100100000000100000001000000100100000000010000000000010001000
10111011101110111100111000101111101100111010111000111101111110001011111110111101110001111110101101101
00010001000000000000100000000000101000000000001000000000000000000000001000010000100000000000000000100
10111110110111100011001111111010100011110011110011111011110110111111101101101111111110010011000000011
00001000000010000000000000001010000000000000000000000001000000010000000000000000000000000000000000000
01101011110111110110111011010110111010110110011111110011111011011101001011010101110111001001011111101
00101000100001000010010000000000000010100100000000100000000000000000000000010000000000000000000001000
11111010011100111111101111001011111101101111101111110001101101111000111010111110110111111110101101001
00000000001000000001000010000000000101000010000000000000001000010000000000000010000001000000000000001
10100111111110111011000011101111101111010110011011011101111011110111011010100011111101101010101101111
00000000000000000000000001000001000100000000000000000000100000000000000000000001000000000010100000000
10111011111001101110011101000111111001011111101110101101111001110101110001111111010100000111101111111
00010000000000000000000000000000000001000001000000101000000000000100000000000000010000000000000000000
00111110111011101011000111110111101101011010111101101011011101101111101011111001101111101110101110110
00000010010000000001000000000000000000000010000000100000000000100000100000010000000000101000000100100
01100001111111101111011110111110101111110111110101111101110110101011101110111111001011101110011111100
00100000000000000010000100000100000001000010000100000001000000101000100100100000001000000100000000000
01111101101111010110101111011111101011110101001110111101101011111011110011110111011110111100110111110
00000100101000000000100000010000000010000000000000010001000000100000100000010000000100001000000000000
01110000011111110000111111111010111000001110101100001111110111111111111100011111010110010111111011100
00100000000000000000000000010010100000000000000000000000000000000100000000010000000000010010000000000
11101001011011111110100011101101111100111010101100111001010111011110101111011011101111011000110111000
00000000000000100000000000101000000000000000000000000000000010000100000000000000000000000000000000000
10011111100110100111011011011111111010101101100010111110011111110011011111011001111111001101101000110
00000000000000000000010001000100000000100000000000000000000010000000001000000000000000000000000000000
10011110111010101110111001011110101011100111101101111111100101001110110010011111111100011011111010111
00000000000010000000000000000010100000000000100000010000000000000000100000000000000000000001000000001
01101110011111101011111101011100101100101011101111110101010111001011001111100111011111100101111100111
00000000000010001010000000000000100000000000000000000001000000000000000000000000001000000100000000001
10111101010110100011110111111001011111001111110011110110111101011101110110110111101011110111011111001
00100001010000000000000000000001000000000100000010000000010000000001000000100100000001000001010000000
10111100110100111110110111011001101010111111101101111001110101011111011110101001110011100101011101110
00000000000000000100000000000000001000000001000000000000000001001000000000000000000000000101000000000
10010110101100101111111010011110011110110011110011010110101101111110101111101001101111101101110101101
00000000000000000000000010000000000010000000000000000000000000000100000000000000100100000101000000100
00000110011111111111111011011101010111001001001101111011111010101011011110101110111100111101101111011
00000000000000000000000000000000000000000000000100100010000000001000000000100000001000000100000010000
11011001110011011111001111110110111100111111100110100110101111111001111110101111001010111110101110110
10001000000000000000000001000010000000000000000000000000100100000000100000100001000000000000000000000
11110010111001111011110101010101111011001101111110110110011101111010011101111101001011111000111110101
00000010010000000000100000000000000000000000001000100000000000000010000000000000000000100000000000100
01110101111011110011101011101110101111110101011010110111010111110110101010111011110110001011111110110
01000000000010000001000000000100000010000000000010000000000000100100101010000000100100000000000000000
11011011110100110111011101111111110000111111101110110100101111111011111110110100100111110111101011010
00000000000000010100000100000100000000000100001000000100000000000001000000000000000010000100000000000
10110100011110011111100011111111101110111110000001110111101111101011110101111111110101101011011110110
00100000000000000000100000000000000000000000000000100000100001000000010000000100000100101010000010010
11011110111011101110110111110001001010111101111101111101111001101111111011111011111011011011111110011
00010000010000000000000000000000001010000100000100001000001000000000010001000001000000010000010000000
11001110110011111010111001101111111011000110011111001110001111110111111110010100111101001111100111011
00000010000000000010000000000010000000000000000010000000000000000001000000000000000000000000000010000
11101111001010011111110101110111101110101111010101101110101111100110011110110010110111001111110110111
00000000000000000010000000010100000000100000000000000010100000100000000000000000000000000000000010000
10111101110110111010110110010111100111111111001011010111110011110100111110111110011011101011110011110
00010000000000000000000000010000000001000000001010000000000010000000000100010000000001000000000000000
10111100101111011011101110101111011011011110011101011101100110110110110110111101110010101100111001111
00001000000000000000100000000000010000000000010000000000000000010100010010000000000000000000000000000
01101101110111011110111101011100101101011001111001111110011111001110110101011111011111101010111111110
00101000000001000000000000000000000000000001000000001000000001000000000000000010000010001000000001000
11010111011011001111101111001100111101110010111100011110101111000110101111111010111010111001110110111
00000000001000000000000000000000100000000000000000000000001000000000000000100010010010010000000000000
01101110101111010101111110101100110111011111000110011111011001111100111110111101110111011011010111110
00000010000001000000000000100000000000000000000010000000000000000000100000100000000100001000000000000
11011011010110010111111111011101010111101010111001110010111100101101011110111111001101011110101010111
00010001010000000000000100000101010001001010000000000000000000000000000010100000001001000000000000000
