00000000000000000000000010000000000000000000000000000010000000000010000001010000000000000000000000000
01110111011100111101011110101110100111111011101110101110111111100111010111101000010010110010111111001
00000010001000000000001000101000000000010000000000000000000000000000000000000000000000000000010000000
01100101011011011100101111110101011011001110111100111111000111101100110111101111000101001110100111111
00000000000000000000000000000000000000000010100000001000000000000000010100001000000000000000000000000
10101110011111101111111110110111100001110011111110010101110011110101011011010101110111101111011011110
10000000000010000010000000000000000001000000000000000000000010000100000000000000000000100000010000010
11100111110010010101101111011111100111110101101101111101110010111101010011111110111101011011011101110
10000000000000000000000001010000000100000100100101000000000000010001000000000010000000000010000000000
11101011101111001111101011011011110101110111111101010100111101011001101111100011101100111111101111011
00001000100100000000101001000000010100000001000000000000000000000000100001000000000000000010000010000
10011111111010101110111011100111111001110110111011110101011111010001111011011011001110111011011010111
00000010000000000000100001000000000000010100000000000000010000000000001001000000000000001000000000000
11101111011101111111000110100101110111101111011001111110111011101110000100111111110101111110111110110
10000010000000000000000000000001000001000100001000000100000010000000000000000000010000000010000010010
11011101101110111110111110111101101110010111101111111010011001101111110010011111111011011111011001110
00000000100010010000010000100000001000000000100000000000000001000010000000000010000010010000000001000
10111110110001001111011111111001011010111110100100011100111110011111101011111011101110101111101011110
00010000000000000000000010000000000000010000000000000000000000000000001000001010001000000010000000000
01110011110111101010110111010101111001111100100111110101111011110001011011101011001110111110111110000
00100000000000000010010000000000000000010000000000000000100000000000000000001010000000000000000000000
10011010111111100101010111101111100111101011001011111001101100011101110111001110100110111111100011111
00000000000000000000010001000100000000000000001001000000000100000000000000000000000000000010000000000
10101101111111001110110111111011001101011101111110101000111111011101101111000111111111111010110010011
00100000001000000000010010000000000000001000100000100000000000000100000001000000000100000000000000000
10111011101111011011001111110110100011101111011000111110110101111100011100111011110000111001110101110
00001000000010001010000000000000000000001000000000000000100000000000000000000000000000000000000000000
10110101111110101110011101100011111101011111111011111101110000101000110111011100110111001110110110101
00010000000000000000001001000000000001000100000000000000000000000000010100000000000010000000000010100
10100111101101111011011101100111011111100111111101001011010111100111011100110111110110111011000110111
00000000000000100000001001000000000010000001000000000000000000000100000000000001000010100000000000000
10110110111010101111100111111001110110001111010111110100111100111101101110100011011110111110110001011
00010010000000000001000000100000010000000000000000000000001000000000001000000000000000000000000000000
11011011100111111011101100111101110111011011100111101100111100101101100110101111011110110100111111101
00001000100000000000001000000000000010000001000000000100000000000000000000000000000100010000000000000
01110111001110101111111011101100101000111111111001010110111111001110111001101111011110011111001011110
00000000000000000010000000000000001000000000100000000000000100000000000000000100001000000000000000100
11010000111101110111110101000111111100111111111110100000110110001011111111010111010111110101110101111
00000000000000000000000101000000000000001000000000000000010010000000000000000010000001000000100100000
01001111101111110110111010111011011111100101111110110101110111101010111110110111001111011011110111101
01000000100000000100001000000000000100000000010000000100000000000010010000000010000001001000000010000
01111111100110101010111101111100111110101110011101111001111111110001001011111101011100111011110101110
00001000000000101010000000100000000100000010000000000000010000000000000000010001000000000000000100010
11010111101110111001100011101111001110110110111011101110011010111000111111011101110111011101111001011
00010010000000000000100000000000000000000010000000000000000000100000000000001000100100010000000001000
10111001101110011111011100011101101111010110111111101001110101111101011010100111001111111111001110110
00000000000000001000010000000000000000000010000000000000100000000001001010000000000000001000000000010
10110011011110110000111111111101001110101111101011111110100011111101000111011011000110111011011110110
00000000000000000000000010000000000000100000001010000000000001000000000000000001000000000000000000000
11010100110101111110111110110111010110110101001101101011101011110101111011111101101111011111110010011
00010100000000000000100000000000000000000000001001001000000000010100001000010000001000010000000000001
01110111100010110111101110011101111011101111111101000111011011110111111011101110111010011010111111100
00010001000000000000000000000100001000100010000000000010010000010010000010001000010000000000000000000
10100011111111110101011111001110111010111110000011111111100010100000111111011111111011011110110011111
00000000000001000000000000000100000000010000000000000000000000000000000000000000100000000100100000000
10011110111111010010101100111111011101001011110111101110110111101111110111001111111101110010001101110
00000010000000000000000100000001000000000000000010000000100010000010000100000000000000000000000001000
01010101111100111111001110101001101111101110111111110101001001011111111001111011110100111111011110101
01000000000000001000000010100000000000000000010000000000000000000100000000100001000000000000010000100
01011111101011111111010010101110101000001101111011100111101110101111001011010111111110111101001110110
00000000000000000000000000000000000000000100100010000001001000000000001000000000100000100000000000010
01111011010011111111011101110111110110101011111101110101111111001101011100100111110110011110110110111
01000010010000000100010000010000000000100000010000100000001000000100000000000000000000000000010100000
01101010111011101101011101010101111101101011011100110111101101101110111001010101110101011111100111110
00101010010000100101000100000000000000001000000000000000100000000000000001000000000000000010000000010
01111011111011011111011101001101111111001101101111001011001101111101111111101101101111111101001010110
00001000100001000100000100000000000000000000001000000000000000000100000100000000101000000000000000000
11010011011101111011011000111100101111101111111001101110110111001111110110111011111110000001111110101
00000000000000000000000000000000100000000100000000101000000001000000000100100001000000000000000000000
11111110110100111011011110011011001111001101010011101111000011101101110111101111110001101100111111010
10000000000000100000000100000000000000000000000000000001000000000000000000000000000001000000000010010
11101100110010111011011111011010111100111011110111011111101111110101001111110011101011111010111001110
00000000010000000000000000010010000000001001000010000100001000000000000100000010001000000010100000010
01101101111010011111101110110111001011011111101110001110101011101001110111101010101111101110101001111
01000000000000000100001000000100000000000000000000000000000000000000100000000010100000101000000000001
11010111101110111001110101101110110111111001111001101111111001011011111011101111100000101101100111110
00010000000000100000000000101000010100000001000000000010000000001000010000000000000000000000000000000
01011110010011110111111110111010011111010111001101110111101011001110110111011111010011111110110111101
00000000000000000000100000000000010000000000000100100000000000000010100001010000000000100000100001000
11001111110100011110101110100101101001111101111110100111111111110110100111001111011110111110100110111
00000010000000000010000000000000000000000000010000100000000100000000000010000000001000001000000000000
11011111100010111111011111001111111001011011011101110111100001111001110101111010110100111111110010101
00000000000000010000010000000010000000000010010001000001000000000000000000000000000000000000000000000
01110100011110100001011111111111101111101001111111100101011111101111011101101101011111101100111011011
00100100000000000000000000000001001000001000000001000000000000100000000000000000010000000000100000000
10110111101111110111100101010110111101110111100101111111010111011110011101111101111100111101110110101
00010000001000000000000000000100000000100001000000000010010001000000000100010000010000001000000000000
10111111011101111011101110111011010111111100101011110111011010111001111100011100111101101101111100111
00000100001000001000000100001010010000000000001000100001001000000000000000000000000001001000100000000
00111111010101101101011111111001111010111011111101011111100010001111111011010011111011111001110011110
00000000000000000100000000100000010010100001000001000000000000000000000010000000000001000000000001000
01111011101111101101001101101011110001010111111110110111101101111101101110110101111111110010111010110
01000010001000000000000000100000000000000000000100100100000100000000100000000000010000000000100000010
01010111111001001111011011011001110011111101111110110010111110011110000101110010110110111110101101111
01000000000000000001001010000000000000000001000000000000000000000000000000000010010000000000100000000
11101101011011101011001010101111111001110011101101111111001111101100100110101111001100001011111010110
00000001010000001010000000000000000000000000000100001000000000000000000000000000000000000000001010100
11010011111111111010001101110101111011001111110110111101101110101101101111011111101101010111001111110
10010000000100000000000100000000010001000000000010001001000000000000000100000100000001000000000000000
11111011001101110100010000110111101011110011111100110101011101110111001110111101101011101101111110010
00000000000000000000000000000000000000000000000000000000010000100000000010000000000010001000000000010
