00000000000000000000001000000000000000000100000000011000000000000000000000101000000000000100000010100
01101111010110011011111111001110110111011111110101000111111011100111100111011100111001001011011011111
00000001010000000000000000001000100010010000000000000010000000000100000000000000000001000000000000000
01101101011111001110110111100111110111101001111111001101110110111101100110010101111010111011011111010
00000000000000000000100000100000000010000000000100000000000000000000000000000000010000000001010000000
11011101110111010110011101110011111001101011100010101011111111101010110011110101111010100110111011101
10001000000000010100000000000000000001001000000000000000000010000000000000010100001010000000000000000
01111110001100111011101101011110110001000111111101111100110101111101111000000111111111101111101110110
00000000000000001000000000000000100000000000000000000000010000000000100000000000000001000100001000000
01111101011011111011001111100101001111011101001111110110011111011010111111110111111010111011100110111
00100001010000000000001000000000000000010000000001000100000001000000000100000100000000100001000000000
01101011100111011110011110111110111111011111100011010101111110001101111010110111001011110111011101101
01001000000000000100000010000010000100010000000000000000000000000100100000000000000000010100000001000
10101110011111100101111110110101111111001011111010001111101100111110111010011111100111010011111111100
00101000000000000100010000010101000000001000001010000000000000000000100010000000100000000000000000000
11010011101101011101111101011001011011101111111101100101011011011101010111101111101101111011011110110
00000000000101001000000001010000000000000001000000000101000000000101010000100100000100000001001000000
11100111101110110111100001011110111101111100101001111001100101111010111011111100101101011111010111101
00000000000000000000000001000000100000000000000000000000000100000000000001000000100000000001000000000
10110110101101101001011101110101101010101100011110011011001111111011011001111101011011101111110000111
00100000000000000000000000000000001010000000000000000000000000001010000000000000000010000100000000000
10100111111100011110111000110110110111101111101011011101110111101010111101001111011011111100111011101
10100000000000000010000000000000000000101000001010000000010010000000000000000010000000000000100000000
00100011101011111111101000101111111110101111111010100001111110011110011100110001111110101011110101110
00000000000000000000000000000000100000100100000000000000000000000000000000000000001000101001000100100
11111100111000111100011111110101110111110111010111111101010001111001011110111101101010111111110101101
00000000000000000000001000000001000001000010000000000000000000000001000000001000100000000001000000100
10111100101100110110111101101011111101011101101110101100111101010111111001110111100111101011101101110
00001000000000000000000000101010000000010000101000000000000001010000000000000100000000101000000000000
01110111011011110010111110101010110001111111011110111010111100011101011110111111010111101010110011110
01000000001000000000001000000000000000000001000000100010000000000000000100001000000010000000000000000
00111100101010011111111111110101011111110011001010110111011100111101011111010100111111011111010110011
00000000000000000000000100000001000000000010000000000000000100000000000010010000000001010000000000000
01111100111011011111001101110011111010111111011001110011110011001110111110111001111010100110111011010
00000100000000000100000000000000100000010000000001000000010000000000000000100000000000000000000000010
01111101111110110010100110111101101011110011111111001101101011111101011111010100111011101110010111111
00000000100000000000100000000000000001000000010000000101000000010000000000000000010001000010000000000
01111101011010111011010111010101100111011111010111111001111110011101011011101001111111011111001011011
00010000000000000001010100000000000000000010000000010000000000000000000010000000001000010000000000001
11111100101010101100111010010111101111010001101011010101011111111101110111010101011110101101011110110
00000000000000000000000000000001000001010000000000000000000000000100000000000100000000000000000000000
11111001110110101001011011111100101111011011101101011111111001110101001111100100110111110110011111101
00000000000000000001000000000000000100000000001000000010000000000000000010000000000000010000000000000
11010111110110111010111011101110000011111111101101100111111000111101110111110001011010111011010110111
10000000000000100010000000001000000000000000001000000000000000001000000000000000000000000000010010000
11110001111100100111010101111110101101111111111111000101110101010011101111101111001001010101111001111
10000000000000000000000000001000100000000100000000000000000000000010000000000000000001010000001000000
01101101111011110001110001111111100100011111010101111010101011111101110111011101101101111111001111010
01001000100000000000000000000000000000000000000100001010101000010000000010000000000100000000001000000
11101111011100101110110111111011011111110011101010010110101101101001100110111110111001011111111001110
00001000000000001000000001000000010000000000000000010000000000000000000000000000000000000010000000100
10110011000111101111111101011111101110001100011110111111001101101110100011111000001111100011111111001
00100000000000000000100000001000000000000100000000000000000000000000000000000000000000100000000000000
01110111010111110111000111110110110010110111111101010110011101100111111011110110101110111011111110101
00000000000100000000000010000010010000000000000101000000000000000000010000010010100010000000100000000
11100011111101000111010010100101110110110111101111101101101110111001011110100111111000110111110111110
00000000010001000000000000000000000000000000000000000000000000000001000000100000000000000001000010000
01011111101101111101101101101100111101001001001110110111101100110111111100010110111011111100110011110
00000000000001000000000000000000000000000000000000010100000000000100000000010100001010000000000010000
11010011110111011100100001110110111110111111001001101110011110101101110110011010111010111110111010111
00000000000010000000000000000000000000010000001000000000000000000000000000001000000000000010100010000
01111011000110111110111110110111011110110110010101111010001111110101011101011110110110111010011011101
00000000000000000100001000010000000000000100000000000000000000000000000100000000000000100000000000000
11110101110011011111010111110110111011111100110001101001111011110111101111111010100011101011011111101
00000000000010000010000000100100000000100000000000000000000000000010000000000000000001000000000100000
11011010111110110010111101011011110111010111110101110010111011110111101011100010101110111101101111110
00000010000000000010000000000010000010010000000000000000001010000000000000000000100000001000100010000
01111101011011101101111001111011001111111011011000100111010110111001111111001111011011100011111110101
00010000001010001000000000010010000000000000000000000000010100010000000000000100010001000000000000000
11111101101100010101101101111111001011111011011011101001101111010100011111101101111011011111101000111
00000000000000010000000000000100000000000001000000000000000000000000000001000000010001000000000000000
11101111011110110101011011110111110011010101101111000111110101101101001111111000111101111101101111110
00001000010000000100000000000000000000000101000010000000000000000101000000000000000100000100000001000
11111100111101010101101111101011011011100011111101011110111111100101011011001111011111011101101111101
10000000010001000000000000101000000000000000000100000010100000000000010000000001000100000101000001000
10001100111111110110001111111111011110110101110011100110110110111111100101010101110011111010111011110
10000000000000010000000000010000010000000000000000000000000000100000000000000001000000000010000000100
01011111011101111100010111011001110001111110101110101110101111110111011110111110101011011111011010101
00000000000001000000000000000000000000001000000000101000000001000001000000001000101010010000000000000
11100101111100111110011110110011111100101111110110101111110000011111101111011011111010111101011100101
00000000010000000000000100000000000000100000000000001000000000000000100100001000100010000000000000000
01111110101110111110010110111110101011110011011110111101110111110101110111010101001111101111101110110
00100000100100000000010100100000000010000001000000001001000001000000100000010100000000000010000000000
01111001111111111000110111100100011110111001101110011101111010111001101110101010101110111100111111010
00000000001000000000000000000000000000000000001000000100000000000000000000000000000010000000001000000
10101101011111110110111111101111000001011111101111010101011111010111001011111111111001100110111101011
00000000000100000100001000000000000000000010000100010100000000000000001000001000000000000010100000000
01111101101111011101111101010110110111101011111110001110011011001111011110110101111001010101110111011
00000000100100000100000000000000000010001010000000000000000010000001010000000100000000000000000000000
11101011101001101111010111100111010110101110101110110111011110011011111000111000101001111110111001111
00000000000000000010000000100000000000000000000010000000000000000000000000000000000000001000100000000
11100011111011011111011010100011100010110111011111110101111101101110011110100011111111010111011001101
00000000001001010000010000000000000000000000000000000100100000000100000000000000001000000000000000001
10101011111101001001110111011101100011011111111101011101011101101101011011110111101111101101101111101
00000000000000000000000000010000000000000001000000010000001000101000000000010100000100000100000001000
00110111101100100110111101011111011110001011111101011011010110110111001111010111111000111010101110111
00000000000000000000000000000010001000000000000000000010010010100000000010010000000000001010100010000
01111101101111110000111110010101011101110110111100111101111011111010011110001101011111110101110111011
00010000000000000000000000000000001000000100000000010001000001000000000000000000000001000100000000001
00101111011110111100101011101000111111011111110011011110101011111110011111100001110111100001111111101
00000000000000000000101000000000000001000000000010000000001000100000010000000000010010000000000000100
