00000000000000000000000000000000000000000001000000000010000000000000000100010000000000001000100000010
11011100000110111011111110111011011011100011011111110110100001101011011110010111111011010110000111111
00000100000000000000000000001000000000100000000000000000100000000000000000000000000000000000000000000
01111100110100100100101111101011111111111101101100010110111101101010111110111011101111101011111111001
00000000010000000000000000000000000000000000000000000100000100000000000010010001000001000000001000000
01111011110111100110101111000111111001011111101110011011110011001011000111011111110100110110111111001
00001001000000000000100000000000000000000100000000000000000000000000000001000000000000000000100000000
11110101101010110110110110010111000111111011101010010010111101111000101111001110011011101111010011101
00000000100000000000000000000000000000000000000000000000000000000000000000000000000001000000000000000
10011011111001011111111100000110101111110111110001110011010111011011011111100111111011011001111010111
10000000001000000000100000000000000000000000000000000001010010010010000100000000100000000000010000000
11011110110101110110111111011111100010000111011110111101001101101111110011111010111111010011101011101
00001000000100100000000000000000000000000000010000100000000000100010000000010000000000000001000000000
01111111101011111101001001011011110110101100011111111100110110110101000101110111111011011111011101101
00000100000000000000000001000000000000000100000000000000010100000000000000000000001001000001000101000
11001010111001101110111111100101111011011110110101101110001111101110111100111111110000001011101111100
10000000000000000000000010000000000001000010000000000000000000000000000000000000000000000001000000000
11101011101110111010110111011011010111111001100001110111101011111110101010100110111111101111101011110
00000010000010100000000010001000000000000000000000000000001010000000000000000100000100001000001000000
10000111111111010101010110100011111110011101100111111011010101011110101011111001111101011111010111010
00000000000100000000000000000000000000000000100000000000000000000100000000000000010000000100000010010
11011101101111011010011110101110101001111101101101111010001011100111101110011011011100111010111010101
00000101001000000000001000000000000000010000000100010000000000000000000000000000000000000000000000000
11111001110111111110111001011010001001111011111110111100010011110011111110111011011011001001110111011
10000001000001000000000000010000000000000000000100000000000000000000010000100010000000000000000000000
10111111100111011110101110111001011101101110100110111011111110011010111000111010111111111110101001100
00100000000100001000100100000000000000001000000000001000100000010000001000000000000000000000000000000
11010110111011100111110110110011110111000111101011101111011011110110111111011110110110101110011111101
00000010010000100000000010000000000001000000000000000001001000000010000000010000100100000010000001000
01101100111111011011011000011010110111010111110010110101010111111110010101110000111010101110111101101
00101000000000000000000000000000000000000000000000000000000000000000000000000000100010000000001000100
11111011110100100111011100011110111010111011111101010111110011010110110001111100111111011111011111001
10000000000000000000000000010000100000000001000000000100000010000000000000000100000001000010000000000
01101101011111111001100011111011101110110111101110010101111101010111111110010011111101010101110101010
00100000000000000000000001000010000100000000000000010100000000010100000000000010000000000000000000000
11111010111011101001111011110101110111101011100111101111011110101111110010101011011101111001101110110
00000000100000101000000000010100010000001010000001000010000000001000000000000000001000100000000000000
10111011110001111101111000111010111100000101111101011111010111110011011111101111100111001101111011110
00000000000000100000000000000000000000000000000101000000010000000000001000001000000000001000100000000
11011101100111110111000011010111000111101100111111001111111011011101101110111101100111110101010111110
10000001000000000000000000000000000000000000000100000001000000001000000100001000000000000101000000000
11101011101111011110101011110111100011111110010111011111010101111010101110111110011010110111011111110
00001000000010001000101000000000000000100000000000001000000000000000000100001000000000000000000100000
11011110110101111001111110000111110101110110110111101110110101110101011010111101110111010110111010111
00000100000000000000000000000010000000100010100000100000000000000001000000000000100000000000001010000
11101100011110101111101110010101111110011110111101011011011111110110011011010101110011111101011011000
00000000000000100010000000000000010000000010010000000000001000000000010000000000000000000000000000000
10111110100111100111111010111010111011101011011011011110110011111001011011101010101111100011110111110
10000000000000000010000000100010000000000001001001000000000000000000010000000000000001000000000000000
10111010111011111010101111011101111001111110001110101100111101001011011111111000111011101111110111011
00001010000000010010100000001000000000000000000000000000000000000010000010000000001000000001000010000
01110110111111101110001101001101110111011110010110111111001111001011011001111001111111011110100101110
00000010000000000000000001000000000000000000010000000100000000000000000000010000000100000000000100010
10111110101011111110110110010111101010001010111110110111110010111100101111111010111010111111100111101
00010000000000100000100100000000000000000000000000000000100000000000000000100000000010000000000100000
10001110100111111101101101101111010101101001111111110011000111110110111001101111101111011110111000001
00000000000000000000100000000000000000100000000000000000000000100000001000000000000000000000000000000
11001111011011010111101011101111110011101110110101001111110010111111011111101101111100101110011101101
00000010000000000000001000000000000010000000000001000000100000000000001000001000000000101000000000000
10111110111011110111101111100111111001111001011110001110111101111101100101110110111101101001111111011
00010000100000100010001000000010000000000000000000000000100001000000000100000000010000001000000010000
10110110110111100111110111100010111011101101001010110101111110101011111110101001011101010111110101011
10000000000010000001000000000000000001000000000000000000000000101010000000000000000000010001000000000
01010011111101001111111011010111101110101010111010010100111110101010111110111111011101101101111111010
00000000000101000000010000000000000000000010100010000000000000000000000000001000010000100000001000000
11001101011101111011011111100101101110011001111010110101111100111110001011111000101111100010111111010
00000000000100001000000000000000000000000001000000000001000000000000000000000000000100000000000010010
01101110101111111000010111101101111010001111101011101110111110101011101011101001111010101111101010111
01000100000001000000000000000000001000000000000000000010000000001000000000000000000000100001001000000
11010001000111110101011111110110011101011011111111101010101110111010111101111100111110101011111101101
00000000000000000000000000000000001000000000010000000000101000001010100000100000000000001000001000000
10110111011010110111101111011111110001011111110110011101111111010111011101100110011111110111010111010
00010000001010000000000100010000000000000100000000010000010000000100000100100000000000000010000001010
11110111111100011100111001111100110001111111101111010101100100110111101010010110011110100011111111101
00000100000000010000001000000000000000000000000000000000000000010001001010000000000000000000000001000
10101110101101011111101110110011111010111110111011011100111101100111111110001011110101101011111111001
10101000000000000100000000000001000010000000010001000000000100000000000000001010000100101000100000000
01101101111011001110011110011101011111011001011101101110011111111101101011011101110001110111111111000
01001000001000000000000000000000000000000001001000000010000000100000000000010000000000010000000000000
10111000100011111101111110101110101111011110001011101011111110101010111011011111101000111011110101110
00000000000000000000001000000000100100000000000000001000100000000000001001010000000000010000000001000
01000011011111111011110111001111101111001111111001111110110101111010010111101110101110111100111111100
00000000000000001000000100000001000001000000100000001000000000000000000010000100000000000000100000000
10110111011100111111010111011101111001110101111111011101001111001110111011001101011111011101010111110
00000010000100000000000001000000001000000000001000000001000000000000000000000000000010000101000000010
11101011110100110111011010101111101101111101100111010011111111101011111101101100110011110101111111001
00000000000000100100001010100000001000001001000000000000000100000001000000000000010000000000010000000
10111010101011101111011110101110010101110011111110011111110110011011011111001111000111011101110110011
00000000000000001000010000000000000000000000010000000010000000000000001000000000000000010001000000000
01101111000111110110111011110111011101101110101111101101110110111101111100111101001111111010111101010
00101000000000010010000001000000010000001000100000100000010000000100000000010000000000100010100001010
11101010001111011100111111011101010111111011111010101111101101001011110110011010111010111110011101101
00001000000000000000000000001001000000010010000000100000000000000000000000010000000000000000001001000
01001011111111111011100101111010111010110011011100011101100101111011101111100111100111011010111110110
00000000000001000000000000100000000000000000000000000100000000000000000000000100000000010000000000100
01100110111110111011101111111010111000010101110110111111101001001111101110111110101001101101010111011
00000000000000100010000000000000000000000101000000001000001000000000000000000000000000000000010100001
10111011111001111001001010101111011011010110010110111011001111111001110111011011111101111110111110011
00100000000000000000000000000000000000000100000000000000000001000000100010000000100000100000100000001
11101101101110111010110111011111011101001111011110101101111110010010101111110001110111101011001111101
00001001000010100000000001001000001001000000000000100100000000010000000000010000000000000000000001000
