00000000001000000000000010000000010000000000000001000000000000010000000000000000000000000001011000000
01111011110011111001101100101111011111001111011110010111011101110111011111011111100010110101111101110
00010000000001000000100000000000000010000001000000000000001000000100000100000100000000000000000001000
01110011100011111010111110100101011101111011110000111111100111110101001111110111001011111010011101101
00000000000000000000000000000100000000000000000000001000000010000000000001000100000000000000000001001
11100111100011011101111000110111101111100101101101011111110110111111011001010111111011001011111001011
00000001000000000000000000000000001000000000001000000001000010010000000000000010000000000010000000001
11110001111111001100111101101110111101111100101111111010110110100001111101111110111101101010100111111
00000000010000001000000000100010000000100000000001000010000000000000000000000100000100000000000000000
01101101000101011111101101101110111110110011101101100011110101011101011111101111001110010111110111110
00100101000000000000000000000010100000000000001000000000000000000000000100001000000100000000000100000
01110111110101011111110111011110100110111111010101110110001110001111101111110110001111011110110111010
00000000100100000000100001000000100000000000000101000000000000000000000001000000000001000000000000000
11110101101011111011110001001001111010001111111110110000100011000111011110111010111100111101101111100
00000000100000000000000000000000000000000000000000000000000000000000000000000000000000000101000000000
00011101111111011001111011101001111101101111111101010111111100010111111011101110101111001110110011111
00000000000000010000000001000000000100000000100001000000100000000000001001000000000100000010100000000
01111110100111110111011111001101010111111010111011110011111011110101110101011110110110110100111111011
00000100000000000001000001000000000000000010000000100000010000000000000001000000000100000000000010000
01111101111101101100111111001111110101101101101110111011001011011111011011111110101111011010111101011
00000100001000000000000010000000000000000001000000001000000000000001010000010000101000001010010000000
10101011111011111010110111001001101110101111110011011111011111000011010111000111101111101100001111111
00000000000010000000000000000000000100000000000001000000010000000000000000000000000000001000000000000
00011111001111111001111011111100111110110101101101110011110101111101101011010011111011011001111011011
00000000000000100000010000100000010000000100000000000000000100010000101001000000000001001000000000000
10111011011111101110101010100100101101011111111011101101101111110011011100101111000111011111101011110
00001000000001000010100000000000000000000000000000000001000000000000010000000001000000000001001001000
01011101110110100110111111001111011101101111011110111101011100111101111101010010111011011011101111110
01010000000000000000010000000100000000100100000100000001010000000100001000000000000000000000000100000
01111110111011101101110101110111100101011011111010101101011101110111101100111011111000111101101101101
00000000100000001000000000100000000000000001000000000101010000010100000000000010000000000100000000000
11101010111010111100000011111111111010111100111100010111101101111111001111011001110111100111010111010
00000000000010000000000000000000010000000000010000000000000000010000000100000000000010000001010100010
01111101111101111110101001111001101011010111111101011010110111111011011011011101011011010111110111011
00000100100000100000000000000000101000000000010001000000000000100000010000000000001000000000000100000
10101111111011011110010011111111110110101001011011101111100111001110111001110111010101111011101101111
00100001000001000010000000000010000000100000000000000000000000000100010000000000000000100000000100000
10111011111111100110101011011100111111101011010110011101100011111110111010011110011111001010011111101
00001000100000000000000000010000001000000010010000000000000000000100000000000000000100000000000000000
01110111011011011100100111001111111010110101111000111101111101011111110101001101101011111011111011010
00100100010000001000000000000000001010010101000000000100100001000000000000001000000000000010000000000
10011100101111011101011110011111010110110111011011010111001010111111011101110111111110011110111001011
00000000000000000000000100000000010000000000000000000000000010000100000100100001000000010000000000001
01010011111100101111101111101010111111101100101100101111110110101101101111100110111101001111110101101
00000000000000000001000100000000001000001000000000000000000000000000101000000010000001000000000001000
11110101011101100111111101110001101100111011111001011110101110111111000111111001011101110111011110111
00000101000000100000000000000001000000000000000000001000100000000100000000000000000101000010000010001
11011010101101111100010111011000111110111101110011111011110110101011011011101100111101110111110100111
00000000000000000000000001001000000000000100000000001000010010100000000000000000000000100100000000001
00001111111101101011001111011011111100110111110101111110111011111101101011011110100011110111110111001
00000000000000100000000000000000010000000001000100000100000001000000000010000010000000000000000000000
10111101111111101111101100010100111001111111101011110011111101010011010100111110011111011011100111101
00000000100000000000000000000000100000000100000000000010000000000000000100000000000000010000000001000
10111101011110101011001111101101010111101111101110110011001111101100110110110111110001101111011110111
00001001000010100000000000000101010000001000001000100000000000000000000000000001000000000000000100001
10111101101111111101100111000001111111000111011011111001110110111111011011110011101111111001101011011
00001000100000000000000000000000010000000000010010000000010010000100010000000000001000000001000000000
11110010001111111101001110110111111101011011101101111010111111010001110011011111111010011101101111001
00000000000000010000000000000001000000010001000000010010100000000000100000000000000000010000000000000
01101101111110111111101101011110110010100101011111111010111011110110111101110110110001110111110111010
00100000000100000100000000000000000000100000000000000010000000000100001000000100000000000000000100010
11001110111011001111101110110011111011111011010111011101000111111110100111101111011011101011110111110
00000010000000000010000000000001000001000001010000001001000000000100100000000010010000000001000100000
11110010110111000110111111111001011101111011000111011101101110101110111100111011001110110011011111110
00000000000010000000000010000001010000000000000000010000001000100010000100000000000000000000000010000
01111101111011111101000110111110101111101111011101010111011101101111110111011101011101100111010111101
00000000100010000000000010001000100000001000000000000010000100000001000010000000000100000000000000100
10101011111001111110110001111111100101110110111111001111100111111010011101001011101110110110111110101
00000000001000000100100000000000000000000100000100000000000100000000010000000000000000000010100000000
11100101101011110011111100011111010111101011011100011101111111001001110110111010110110101111101110111
00000000000000010000000000000000000100000000000000000001000000000000100100000000000000000100000100000
10011101110111010111011010110010110111111011100110011010110111101110110110111111010111110011101001110
00000000000100010100000000000000000000100000000000000000000001001000100000001000010100000000000000100
01110011011101111101001111011111100101010011101010110111111101011111101001101101100111110110011111101
00010000000000010001000000000010000000000000000000000000000001010000000000000101000000010000000001000
10111100011111010011011011011101010101111101010011100111110110110111001111011111011011110111100110110
00000000000100000000000000000000010000001000000000000000010010000000000000010000010000000100000000000
10111001101101110111111001100111101001010010101110011011010111111101011101111001110111100111011101101
00000000000000100000000000000000000001000000000000000000000000001000000000000001000001000000000000000
10111110111110010111111001011011111110110111111011010101011111010000101111110001111111101111011110100
10000100000000000100000001001000001000100000100000000000000100000000000000000000000001001000000000000
11011011101100111000111111101110010011101110111110111001101011101110111101110111101110101110101110111
00000000000000100000000001000000000000000000001000000000000001000010000000010000001000000000100000000
11101110001111101111001011011110100011110111101011101101011001000111110001111110111111100111011010110
00001000000000000000000010000000100000000000000000000000000000000000000000000100000100000000000010010
01110011010110111100001101111111110101011011101100110101101101111110100111111100110111011001011101101
00000000000000001000000000000000000001010010000000000000000000010000000001000000100010000000000000000
10111111110101001011111111110001001111101101001111110100110011100111111101110001011000111110111111110
00001000000001000000000000000000000100000000000000000000000001000000010000010000000000000000000001000
10110001011001111111110111101011111101111111011101101011111011011010110111110101011111111011011111101
00000000000000000000100010000000010000010000010001000000000010010010000000010000000000100010000010000
11110011111010111001111011110111110101001111101011110010111101101110111110111110110111110010111000111
00000001000010010000000000100001000000000000001000010000000000000010000000010000010000000000000000000
01110111111100101101111011011101011010101011101010011101111010111010111101111101011110101111111010010
00000010000000000100010000000100000000000000000000000000000000000000001001000001000010000000000000000
10110001010111011011101100110111110011011110111001011101111101111001111011011110101001111110101101101
00100000000000000000000000000000000000010000000000000100000100010000000000000000001000000000001001000
11011111001010111101110001111011101111110011101011111101010011101101101101111000010011111110100111101
00000000000000100000000000001000000010000001000000100000000000000001000000000000000000000000000001000
01101101011111111010010010101101001111111010110111101100111010011111111011011011111111010111111101000
00100000000000000000000000000101000000000000010000000100000000000000100010000000010000000100000000000
