00000000000010000000001000100000000100100000000100000000001000000100000001001000000010100000000000010
10001111101111010100111101100101110011110011111001110011001111010111110111011100111111111101010011010
00000000000000000000010000000000000000000000000000000000000010000000010010000000000100000000000010010
11100011011101110100111010111110101101010101111110100110100110111110110101110111100011110011111101100
00000000000100010000000000000000000000000000000000000100100000000010010100000000000000000001000000000
10110000111111111001100111101011110111111100111001100111111110011111110010100111111110011011011110110
00000000000000000000000001000000010010000000000001000000000000010000000000100000000100000000000000100
11101100011111001110110110011011100101011110110101110100111111101000111111010110110111110110111011101
00000000000000000000000000000000000100000000000000000000010000000000010000000000100001000010010000001
10111011110011011111011101110111101110110100111101111001101101110011110101011010111011110100011011111
00000000100000000010000000100000000000000000010000000000001000000000010101000000000000000100000000000
01101111100011011111110010100110111011101111101011111011111000101001011101111100111111101010010101111
00000000000000001000000000000000010000000010000000000000000000000001000100000000000000000000000100000
11101111001010111110101001100111100111111100001111111111001101011110100111110001111110110001110110101
00000000000010000000100000000000000000001000000000000000000000010000100000000000000000000000000000000
10011111101100001111111011110110101111101111101111011111000100101100110011111101011111010111101000111
00000010000000000000001000000100100000001000000000000000000000000000000000100000001000000000000000000
10011111111100011101110101110110011111011111110010010110101011110010111101111110110111001110110110110
10000000010000000000000000010000000001010000000000000000100000000000000100000000100000000000000000000
11011111101101001110101101100101111100111011101111101101111011101011001111110101110111011011001100111
00010000000000000100101000000000000100000000000001000100000000000001000000000001000010000000000000000
11101101110111011110111010110101111011100101111011101101111111010100100111101011011110101011101111110
00000000100000000100000000010100001010000000001000100000000000000000000000100000000000000001000100000
11101001110010111100111110101011110111010010101111101110010111011011101111100101101101111111000111110
00000000000000000000010000100000000010000000000000000000000000001001000000000000001000010000000000000
11010111011110110011111011110111101110111101001001110001111010101111010000011100001011111101101111110
00000010001000000000010000010100000000000000000001000000000000000000000000000000000000000000000000010
10111101100110111010111111011011110001111101111111001101011001111111111010101100011100111110011111110
00000000000100000010001000010000000000001001000000001001000000000000000000000000010000000010000000010
00111111101110110100111001100110101101110111111111001100001010110110010011111110001111111111010111101
00000000000000000000000000000000001000100000000000000000001010100000000000000010000000000100000001001
01101111110101111001111011011101111101010110110101011011111110111011101110111010101010101111001111101
00000001000000001000000000000000100000000000000001000000010000010000000100100000000000000000000001000
10111100111101111000011111110111010111011101111110010100010001110111111111110111101111101101110110110
00100000010000100000000000000010010001000101000000010000000000000000000000100000001000001001000000100
11101101101111100111111011101111100000111101001101111010110111110111111011100101010111110111110101110
00000100000000000010000000000000000000100000000000010000000000000100000000000001000000010000000000100
01111100101001111111101001111000110010011110101101110111101111011011011111101110001111011011110110011
01000000000000001000000000010000000000000000000000000000000010000001000001000000000000001000000000000
11011101110111101110101110001111011101011111001111100110111111010111111010101111111100111101011111010
00000000100000000100000000000000000100000000000001000000000100010010000000000100000000100001000000000
11011111110011010101101111010111011110011101111011001110101111011011110101111001101100111010111111001
00000100000000000100000000000001010000000000000000001000100000000010000000000000101000000000000000000
10100111111010001111011101111110000110111011101001111111110101010100010111111110111101101111010011101
00000000000000000001010000100000000000000000001000000010000001000000000000000010100001000000000001000
00001111111111010011011011111010001111111110111011111000110101011101111110100011111110110101111010110
00000000000100000000000000010000000000001000100000100000000000000000000000000000010000000100000010010
01111011100110101001111000011111101110101110111110100111011011100011111111011010111100011001101110110
00001010000000000000000000000000000000100100000000000000010000000000010000000000000000000000000100010
01111011110011111111010111100001111101011110111110011110111011001111011101011011110101011110111111010
01000000000010000000000000000001000000001000010000001000100000000010000000000010000000001000010000000
10111010101111011111010111101010011111111011001111111101100011000010110010011111101100010111101101111
00000000000001010000000100000000000100000000000000000000000000000000000000000010001000000000000000000
11110111101100001101111111011111110111011001111110010111011001111101100011110110110101001100111111101
00000100000100000000000000000010000000000000100000000000000000000000000001000010100000000000000000000
01111101111100101101011011011101111100111101100011111110110110011100111101110101101011111110111011110
00000100000000000000000000000100100000001000000000000000000000010000001000010000000000001000010000000
01111010111010110111111010101110001000111101101011101101111101011110101100010111101010110011100111110
00000000000010100100000000000000000000000000000000100000000000000000000000000001000000000000000000000
11111001011011011010111011110101101101101101100110111011110110101110011110011111101110111001111101101
00000000010000001010000000000000001001000000000000001000010100101000000010000000001000000000010000001
10101011011010111110101111111001100111101001011110001110111111101000110110111101110011100111111100011
00100000000000000100000000000000000000000000000000000100010000000000000010001000010000000000000000000
11001001110101101101111101001011111111001100111110110110111110101001011110111001001110101111010110110
00000000000000000000001000000000000000000000010000010100010000101000000000000000000000000000000000000
10011100101011110010110011101100011111101111011101011101100111101111011101000011011111101000111011100
00000000000000000000000000000000000000000010001000000000000000001000000000000000000000000000000000000
11110110110111011110011001101111111110010001111101111110011110100010111001011011010000110111110111011
00000100000000000000000001000010000000010000000000010000000000000000000000000000000000000000000000000
10111001000111110111011011110011111101101101101001011111101011100110101111111001101111111011001101001
00000000000000000000001000000000100000001000000000000000000001000000000000100000000010000000000000000
10111110010111100011110111110111011011010111110110100111111011110100100111101111110101111110110011110
00000000000010000000000000100001010000000000100000000000001000000000000000000001000100001000000000000
10110111010111000011101011111001111110101101001111110110110111011101100110101001111011111011110101011
00000000000000000000000000000000010000100000000000010100000000001000000000000000000000100000000001000
01111100111011111011111010001110110101011111001111110011111111011101010110111111011111110000111011110
00000000000001000010000000000010100000000010000000010000000100000000000010001000000000000000100000000
01101101110111001011011011111011110101111101101110111101100011001101010111111001111111010111101101111
00000000000000000000010001000001000100010000000010100000000000000000000000000000100000000100000100000
10111011110111111011110010110111111010110110011110111011010110111100111110101011110001111101110111011
00000000100000100000100000000000001010100000000010000000000000000000100000001000000000001000100100000
10001111001111110111011110010101111101101101110101110011101110111101001110101101110111110010111110110
00000000000000000010010000000000010000000000000100100000000000000000000000101000000100000000001000000
11001101011110011101111011010111110111101011010111110011111111110001011011010111011110111101111101011
00000000000000000001000000000010000100000001000000000000010000000000000000000100000000100000100000000
10110011111010101111101111110110101101111101011101110110110110111110111001110011111101110111110011011
00100000001000000000100000100100000000010001000000000100000000001000010000000000000100100001000000000
01101110111101011011101011011011111010111111001110001000111001110111111110011110111011110111101001110
00100000001001010000000000000001000010000000001000000000000000000000000100000010010000000100000000000
11100011101111110111101001101110010100011110101111110111100110111100010101110011110111001111110011111
00000000000010000000000000000000000000000000100000100100000010100000000000000000000000000001000000001
11111010101111100111011011110110010010111111110100101101111001111011011010111011111001111010011011111
00000000001000000000000000000000000000010000000000000100000000000001001000000000010000001000000000001
10011001111111011110011111101011010011111110011101111011001111111101111101011101101110111111100010010
00000000000010000100000001001000000000000000000100100000000001000001000001000101000000000000000000000
01011111110011101110101110111001001111011001110111101110111111011010011111111001011100101101110011011
01001000000001000000000000000000000100001000000000100010000100010010000000000000000000000000000010000
01010111101111101110111011101111101110011011011110001011111110011111101011110000100111110011101110101
01010000000010001000000001000100000100000000000000000000010000001000000000000000000000100000000000000
01011110011101010110111011111000110110111110111001011111011011111011110010101011111101001101111101101
01000000000000000010000000010000000000000000001000000000001000000000000000001001000000000100000000100
