00000000000000000000000000000010000010010010000001000000000000000000000000000000100001010000000000000
10011001111110111010101011111100011110111110101111011100011111101001111011111011110011011100100111111
00000000000010001010101000000000000000100000000100000000000100000000001000100001000000000100000000000
00001101111011111111111001110011101101101111011011001110111111110010110110111011010111010100111110111
00000000000000000100000000000001001000000001001010000000000100000010000000000000000000010000000000000
10111111001101100110100111101111010010111011011101101111111011111011011101101010101011111011100101110
00100000000100000000000000000000000000000000000100000000100010000010000101001010000000000000000100100
11001011111001011101110111100111110010111011111011110011000111011110111111011000010100011011110011110
00000000000000001000000010000000000010010001000000000000000010000000000000000000000000000000000000000
11110010110101101011110101111100111010101011111101010100111101010100110111100111110111111100011001110
00000000000000001000100101000000000000000000100000000000000101010000000000000000100100000000000000000
01100101111011011010110010110111101111101111110110010000111101101111101011111111011011011001101011101
01000000000001010000000000000000100010000000000000000000001001001000001000001000000000000000001000101
00011111110011001111010010111101111110100111010111110011101111001111010111010101100110110111110100110
00000000000000000000000000000001000000000010010000000001000000000000000000000000000010100000000000000
11011111001000111111101101110101010110101111100110111111001010011110010111100110111110111011100101111
00000000000000000010000000000000000010101000000000010000000000000000000000000000001000001010000000000
10111100000111111111101100111100011111100011110111011011101011110111011110101100111111110010101100110
00000000000000000100000000010000000000000000010010001010000001000100001000000000000000000000000000000
11001111011110111101101111011110011111001011110111010111101110101111101111011111001110110111011010110
00000001001000010000001000010000000000001010000010000000000000100000100100000100000000000100000000000
10111010100101111101111100101111111111000001111111101011110001010111011111001110011011111011101111100
00001000000000000000001000000000000000000000001000000000000000000010000000000000010000010000000000000
01111011101011101011100110110110111010101111100001111101101110011101100101100111111111110100111101101
00100000000000000000000100000000001010000000000000000000000000000100000000000000000100000100000000000
11110110000111111110110011111110110111101100110111010111100110011100111110110011110101001011111001111
00000000000000010000100000000100000000000000100000010100000000000000001000000000000101000000000000000
10111011011001111010001110111101010110011101011111110101101111101111101111110001111011110111001110111
00100000000000000000000000000000010000000000000010000000100010000010000100000000010000000010000000000
00101110110110111110011101011101100111011010010111110110111101011110111010111011111111010001001011111
00000000000000000000000000010000100000000000000000000000000000010000100010000000100000000000000000000
10111101110101101011101101111111000101111001000110111100111001111111011110011010110011111010011011110
00000100010100000000000000100000000000100000000000000000000000000000000000000000000010000000001000000
10011100111111101101101011011110101111011111101101100011101111011110010010011011111001111011011000110
00000000000010000000000010001000000010001000000000000001000100000000000000000000000000000000000000010
00011101111101101111100110111101001111011101111111110010111110110100110100110110011000111101111111110
00000000000000000000000100000000000010000100001000000000100000000000010100000000000000000000000010000
11101111111001101001111001101101100111111011100001011101011101101110111011011011111101111110101010011
00000100000000000000000000001000000000000000000000000001001000000010000001010001000001000000000000000
01111011010111111101111100101011011011110011011110111010001111111011101111000010101101101111110111101
00001000000000010000000000001001000000000001000000001000000000000000100000000000000000000000000100000
11110101111100111101111101011101100010111011111110010111110111001111110110111101110010011110111110101
00000001000000010000010000001000000000000000010000000000000100000000100000000000000010000000000000100
01011011111101010111101001001011110110100100101110111011101101111011101111011011111101101111111100011
00000000000000000000000000000000000100100000000000000000000000001001001000001000001000000001000000000
00011110111110110111101111011110010010111011101100101010111110100111110111011011010111001111110111010
00000000000010100010001000000000000000001000000000000000000000000001000000000010000000000001000000010
11010111011011110111011101111010101001111101110101011111110110010111111010110111011000111010111011110
00000000010000000010001000000000100000000000100000000000000000010000000000000000000000000000100000000
01010101101111011111111011110001101101101110010111101101111011101010101110111111110011101011111101110
00000000000000000010000000000000100000000000000000000100000010001000000000000010000001000000010000100
01111011101110010101010101011101110111110101110111101101111011110100111001000011110101001111100111110
01000000000000000001010000000000010100000000100000000000000000000000000000000000000001000000000000000
01100111111111001101111101110101011011011111100110011111101011011101111111100011111110111111101000000
01000000100000000100000000000000010000000000000100000000000010000100000000000001000000000000000000000
00111111011011111010111000101101101011101101111011011101001111111001110011111011111110101001011011010
00000010000000000000000000000101000000000001000010000000000001000000000000010010000000000000000000000
11111000101110101010111111000111100111101111001111100011001111110111100111011110101011101110101111010
10000000000000000000000000000000000100001000000010000000000000010100000001000000000000001000100010010
11011111101101001101101101010001110011111011101110100111101000101101111111101111111111101100001001101
00000000000000000000000000000000000000100001001000000000000000000000000010000010000000000000000000000
11110111000111110100111111101000110100101110011111111100110111110101111100110110011110111101111101010
00000100000000000000000000000000010000000000000000010000000001000000001000000000000000000100000000010
11001010101101111101001100101111111111001101111110010000101101110011011011111110101010101110001111010
00000000000000000000000000000000010000001000100000000000000000000000000000000000000000000000000000010
01010011111111010101100011110111011010111001111011100111010111100111011011100111001011110111111001001
01000000000000000101000000000000000000000000100000000001010000000000000000000000001000000000000000000
10110111001111101011011111011010110010001111111101101101011110110001111110110111010100111111111100011
00100010000000000001000000000000000000000000010000000000000100100000000000000100000000000010000000000
10011011101101100111101110111111000110111101110111101010011011111001110111100100011111101110011011110
00000000000100100000000010000100000000000100100000000000000001000000000000000000000001000000000001000
10111111100110111111110001110101100110111110110011101011101000011111101110101101101101011101101111001
10001000000010100000000001000100000000000100000000000000000000000000000010101000000000000100000000000
01011101110101101111001110111011101111101101111011100111111011101111101110100101110110111100111111001
00000000000100000000000000010001000010001000000001000000010000100000000000000000100000000000010000001
10110111010111110100111110110101111111110100111111101000011101111010111101111001111010111110110101111
00000000000010000000000100010000000100000000000000000000000101000010000001000000001010000000000100000
11111111000110111001001111011111001001000001111111001010010111001111111110000011001111111100011111010
00000000000000000000000000000000000000000000000000000000000000000010000000000000000000000000010000000
10110111010111010101111010101101110101011111010110101110111100100011111000011101111111101111011100110
00000000000001010000001010100000000000000100000000000100000000000000001000000000000000100000000000000
11110110101110101111101011100110111110111101110110110010110001101011111110110101111110110101011011011
00000000101000100010000001000000000010010000000000000010000000000000000100100000000100010100000000000
10110111010111011101101110110010011101010111111001101011100110010111111110111110101011111011110011011
10100100010100010000000000000010000000000000000000000000100000000000000000010000001000001000000000000
11110101001111111010111111101001110101010111111001100111111110110001110110111011111001110011111001010
00000001000000001000000000000000000100000000010000000000000000000000000000100010000001000000000001010
11110100011101101111110111011100111011101101111110110110110110010101110110011101111110101101110111110
00000100000000000000000010000000001000000100001000000100000000000000000000000000001000000000010100000
01111110110101101011011101101100111111110110110111100100101111010110101111011011011011101101111100110
00000100000000000000000100000000000100000100000000000000000000000000000010000000000000001000000000010
10111010110011100111101011110101111110100111101110001110011111111111001101011110101011111101011111100
10000000000000000000001000010000000010100000000000000000000000100000001000000000001000010000001000000
11110110100110111110100111111010001110111011111111001010001110110110100111111110111011011110011111101
00000000000010000100100000000000000000000000000000000000001000100000000000001000000010010000000010000
01111100110101111101110101011110111011110111111100101011101010011111011101010111001111011010101110011
00000100000000000000000000010000100000000100000000000001000000000000000000000100000000000000101000000
11110101111010110111110011111101101111111010110011110101110011001011101100101011011111010001111010011
00000100000010000000000000100000100100000000000000000000000000000000000000000001010000000000000000000
10110110100111111111101000110111011111111110100100100111000011010001111111101101011100001001111111101
10010010000000000000000000000010010000000000000000000000000000000000000000001001000000000000000000000
