00000000000000000010100000110000001000001100010000000000000010000000010000000010000000010000000000000
10111011111101101111110001111010100011111010111011111011101111011111011100011000100011011110110111101
00000000100000000100000000000000000000000010000000010000000000000000000000000000000000000010000000000
01111101101010100111011101101110111011101111101111011101101101110111101101011011110111011000110101010
01000000001010100000000000000000100001000010001000001000000100000010000000001010000000000000010101010
10111110000011011101011111111110101111111010101111101011111110011001011101011011101110101010110011111
00000100000000000000000000000100100100000000100100001010000000010000000000000000000000000010100000000
00111110110111001110110110101011111101110101101111100101111010110001011110010011111011101000111101111
00000010010100000010000000000000001000000000100000000000000000000000000000000000000001001000000000000
11110110101011111011110111110001110011111101111101110010111101101111111110110100110100110011111110101
10000000101000001000010000100000000000000100100000000000001000100001000000000000000000000000010000000
11011111011111101110101111010001011110111000110001111101110011100101011111101011111010111110111011110
00000100010000000000000000000000000000000000000000100000000010000000000000001000100000001000100000000
00110111111011101110111110110111100111010111110101111001011111111100011101011111110101001010111101011
00000000001000000100001000000100000010000000010100001000000000000000000100000000000000001000000101000
01010111101110111010100111101001111110011011101011101011101010111110101111110111011101111010011111010
00000000000000000000100000000000000000000000101010000000101000000000100000100000001000000000000000000
01111010110110101100111011100110111100101101111101110110010110110101010111101111101110100011111110110
00000000000010101000000000000000001000000000000000000000000000000100000000000001000100000000000000100
10011110111111100100111011110110111110011101110110001011110101110111011110011011100111100100110011111
00000010100000000100000000010000000000000000000000001000010000000001000000000000000000000100000000000
10101111010001011111011010101110111001111111110001111111011000111100111110111101111110110111110110010
00000000000000000000001010000000001000000001000000000000010000000000000000001000001000000000000000000
11101001110101101101110010110111111001110111110011110101111011101101101110111001110111101010110011111
00000000000000000001000000000001000000000100000000000001000000001000000000000000000100000010100000000
11011011110100111011111101011001101011101011111100101111101111001110111100111101101001111111101110101
00000010000000000001000000010000000000000000000000100001000000000100010000000000100000000010001000000
10101110100010111110011111011010101110101111011101111111011110010111010110111110110111101110111111010
00000010000000000000000000000000000010000000000100001000000000010100000010000100100010000000010000000
01011111000111011011001110111111001011110110111101111001110111101101111110011001011101101101111101110
01000000000000000000000100010000001000010010000100100000010010000100000000000000000100100000001000010
11010101010011011111110110111110001111000011111001110111100101111110101110011111011111101010111110110
00000000000000000000100010100000000000000000001000000000100000000010000000000010000000000000100000000
01110010101101011111101101110111110111111011111011011111011011110110111001110101111011101110111111001
00000000000000000000100000010000010000010000010000000010000000010100000000010101000001001000010000000
11110110100110111010011110110110011111011111111000111101110101111101011010101101111110001101110011011
00000000000000010010000000000010000001000010000000000101000100100000010010100000000000000000000001000
01110011110110111111100001110110110101011111101010110100110110110101110111010111011001011111011011110
01000000010100100000000000010100100100000000000000000000000010000000000010010010000000000010000000010
01101111101110110111010111111101111001101101101011011111011011011010110111110011100001110001111111011
00100100000100000001010001000001000000000000000001000000001010000000000000000000000000000000000100000
11110010110101101110111011101011111010001111111110000110111101111101110010100101111011111011111011010
00000000000000100000000001000000000010000000001000000000000000000101000000000000000000010000000010010
11101110001111010100111111111000111111010111001111110111110110001111010111000111110111010111101111011
00001000000000000000000010000000001000000001000000010100000000000000000100000000010001000000100000000
01111101011111110111010101110111101110110111111001111101010111110011001111100111111110101101011110111
00000001000001000100010100100000100100000010000000010000000001000000000000100000000100100000000010000
11011111100111110111111011011011111001111001111100101100010101110110111100010101110111101111110011101
00000100000010000010000010000000100000000000000000000000000000000000010000000000000000100000000001000
11101110001101110111011011011101101101111100111010111101011111101111010011111110101111110010111001110
00000000000100100001010001000000000100100000000000010000000100000100010000000000000100000010100000010
00111111011111010111111011011100110111101111011011101110110111110111101110111101010110101100111110101
00000010010000010010000000010000000001000001000000000100010000000100000000100000000000100000000000000
11101010111111101001101001111110011110011110011111011111101001110111001101100011101111101110110110111
00000010000000000000100000000000000000000100000001000000000000000100000000000000000000001000010100000
01110111101011010100111111111011001010011111110110001111110110101010111100101111101001011011100111111
01000000001010000000000010000000000010000001000000000000000000000000100000000000000000000000100000000
10001111110001101100111101111100101101001110110010011111011111011101011001111011101110111100101111001
00000000000000000000000000000000101000000000000000000000000010010000000000010010000000000000001000000
01111000011111111010111101101111011110110110110110111111001011101010001100111111110111011110111011110
00001000000000000000000101000001000000100100100100010000001010001000000000000000010000000010000000000
11101000110111011111011111010111111110000001001110110111101111101111001111011110111101001111101011110
00000000000000000100000000000000000000000000000010000001000000001000000100000100000000000001001000010
10111011110111110101010001111011111001111011111001101110111101001111011011110010110111011101111110110
00000010000000000000000000100000100000010001000000000000100000000000000000000000100100000100000000100
11000101101110101110111100101111110011110111111001111110000111011111110100110011111110110100011011101
00000000000000000000000100000000010000000000000001000000000000000100000000000000000000000000001001000
10111011101000111001011001111110110010111110111101100101011101111010111111011010110011101100101111011
00000000000000000000000000000010000000000000000000000000000001000000100000000000000010000100000000000
10011111011001110001111111010111011101101111011101011101101110111101110011111010011100011001111110111
00000001000000000000000000000001000100100000010000000001000010100000100000000000000000000000000010000
11001011110111101101111011011111011101111010101011001110010111111101111101001011001110011011011101111
00000000000010001000000001000000010000000000001001000000000000001001000001000000000000000000000000000
10110011110101111111101111001110111011111101000011110111011111101100011110101001110111101001101110111
00100000000000001000001000000010100001000000000000000010001000000000001000000000000000001000000000000
10111001101011100011111110110110111011111011010111111011100111101011111010101101110011100111111011011
00001000000000000000000000000010000001000001000000000010000000001000010000000000000000100000010000000
10110011111110101111101101110011111110111010110101111010101111011011110100100111101111111001011010101
00000000010000100000100100000000010000000000000100000000000001001000100000000000000000000000000010101
11101011111110111001011101111101011110111001111110111111100001110110111001101011110001111011110111011
00001000001000100000000000001001000100100000000100010000000000000000000001000000000000000010000010000
01001101111111011011101001110110100010111011011101011111100111110111100011101111001100110011101011110
00000000000100010000000000000010000000000000000000000000000001000000000000100000000000000000000000000
01110111110101010111011101011111101001011011101010110011101100101101111010110110100111111011110111110
01000010000000000000000000010000000001010000001010000000000000000000000000000000100000000010000100000
10111011011001011111100011111010111101110111101110101101011110111010100110111111110011110111011001010
00100000000000000100000000000000010001000000001000000000000010000000000000000000000010000000000000000
11000101111011010011111011110111110100010110111111110100111110000111111000111010111001111111111011000
00000000000000000000000010000000000000010000000010000000000000000000000000001010000000000100000000000
01101010111111000111100111100111100011110111010101111011110010111011110111011101110111001111011011101
00000000000000000001000000000001000000000000000000010010000000001000000010000100100001000000000000000
11100111101101101011011011111100111101010011011110111101001110001001001110011001111101101110111011110
00000000000000000010001010000000000000000000000000000000000000000000000000000000010000100010000000000
11100011111110010111011101011100111110111011101001110001111111101101111101101010011101111111010111110
00000000000000010100000001000000000010000000100000000000000000000000100000000000000100001000000001000
11101101111100101011111001100010111111100101110110111111101101011100111110111011111110001111111110000
00001000000000000000000001000000000000000000000010000100000100000000000010000000000000001000000000000
11110101111110011101110110001101110110111101111110011101011101011001010110111001011111111101111111001
10000100001000000000000000000000000000010000010000000001010001000000000000000000000000010000010000000
01101100111101110101111111011101011101111001101011111110110101001110111011011111011011100011011010111
00100000000000000100000100000101000000000001000000001000000000000000001000000000000000000000010000000
