00000000000001100000000000000000000001100000000000100000101000000000000000000000000000000000000000000
11001011011111111100101000110110111010010101111100011111111110000111110111110111011000111011011101110
00000000000100000000000000000000010000000000000000000001000000000000010000000000000000001000000000000
11101110101011111011011111011000100101111111101110010111111001011011110111100110011111011100111001111
00001000000000100001000010000000000000000000101000000000000000001000000000000100000000010000000000000
01010111110111110100111011011101110100101110110101111010111011110100111001110111000101101111111110110
00000000000000000000100010000000000000000010010000000000001000000000000000010000000000000000001000000
01110010011101010011100011111110011111110110110110101101111101100000111111010101111101011110111110011
00100000000000000000000000000000000001000000000000000001000000000000000001010101000000001000001000000
01011110001111111101110101011111011111011100111111011011101101111111001101110010010111011110101111010
01000010000000001000000000000100010000010000000010000000000100000000000000000000010000000000001000010
01011111000011010101101110111101100111101110111101111001101001111110111110111110010110111110011001011
00000000000000000000000000000100000000000100001000000000000000001000001000000000000100100000000000000
11111010111011001000011101111010110111101001110101111101101110001111111110101010111110010101111100011
00000000000000000000000000000010010100000000000100000001000000000000010000001000000000000000000000000
10011110110111101111101111110011111101011010110101111010100110111110110111011010111110111110100110110
00000010000000000100001000000001000000010000000000010010000000000000000100001000000100000000000000100
01101111101100111011100110101110110111110011011101011101111101110001010101101110111101011001111001111
01000100000000000000000010100100000001000000000000001000100001000000000000000000000101000000000000001
10101011111011011011001111011100011011011111111001011111011000111111101101110101110110001111111011101
00100000000010000000000000000000000001001000000001000000001000000000101000000100010100000000010000000
11010110110111101011011101011101101111101101101110110111011110011111011110110101111011111100001111111
00010000000000000000010001000100101000000001001000010001001000000100000100000000001000001000000000000
10110010111111100100111010100110101111111111001101110101101110111101011111011111000110101011111011110
00000000000000000000000000100000000000100000000001000000100010100000010000010000000000000000100000100
01111111110010111111100011011011011110011011110111101010111011111001110110101110011111011110101111001
00000100000010000000000000000000010000000000100000000000001000000000000010000000000001010000001000000
01111011110101011010111011111100111111011110011011110110111001010110111100101011001101101111101100111
01000010000000000000001000000000010000010000000000100000000000000000000000000000000000000001000000000
10010111111001101101110011111001111101111111100001001111101101100100111110010110001111000111011111110
00000000000000000001000000000000010000000000000000000100000000000000000100000000000000000000000000000
00110110101111110111010110110111011010111110001111101011111001111101011111001111101011111001101110111
00000000000000100001010000000000001000000000000000100000000000001000000010000000100000000000000010000
11101111010010111011111010101111111110100001110110101110101101011100111001101011111110101111010110110
00001000010000000000010010000001000000000000000000000100101001000100000000000000000000100000000000000
11111001010110011111011111110011010011101011111100111011011011000010111111111110111101101011111101100
00000000010000000001010000000000000001000000000000100000010001000000000000000000100001001010000000000
11111100101101100101110011101111101111111010011101110101011101101101011001111010010110111111110111110
00000000100101000000000000000000100000000000001000010000000000000000000000000010000000000000100000000
01110101010011101100101001001111101111110111011011010111010110111101101111111001111111100111110110110
00100000000000000000000000000000000000000000010010010000000000010000100000100000001000000001000010100
11111100110011011010101011100101100101110110111111100001101111011101110010011111110011111011011011110
00000000000000000000000000000100000000000000000000000000100100010000010000000000010000000000001000000
10111111101111111110001000111011111111100010111110101011111110001110110000111111111110100001101110111
00001000001000000000000000001000001000000000000100101001000000000100000000000000000000000000000100000
11010111101111110001111001111110111111010111011011110100010110111010001111100000101110110011111111011
10000000100000000000100000000100000100000001001001000000000000000000000000000000000000000000000000000
11100101100011111001111110111101110010111111011011111101111001011111100111101101010111101110010111101
00000000000000001000000010000101000000000010001000100000100000000010000001000101010100000000010000000
01111001101010111110110111111111001000000111101111111011010011111111010001011011101111100111011101011
01000000000000001000000100000000000000000000000001000010000000000000000000000000001000000100001000000
11100101111011011011111001110111010101010011110111111010010111011111101011111110111011110011011011001
00000000010001000000000000100000010000000000000000010000000000000000001000001000100000000000000000001
00101111110110110100110110101011111011110111101011001011111011111001110001111010111101110011110001110
00000000000000000000000000100000010000010010000000000000000010000000100000000000000000000000000000010
11001111111111011001001101010101110101101011110101111101010111111101111001101101011011111011010110110
00000001000000000000000000000100010000000000010000000000010000010000000001000101001000000000000000000
11011011011011011110111110111011110111100111011110011011011100100011010110111111110011111010011101011
00000010000000000100001000001001000100000000000000010000000000000000000000000010000000000000001000000
10111011101110111110011110101111011111100011100111101011111100110111101111111000000111111100110011110
00010001000010000000000000100010000100000000000000001001000000100010000100000000000000000000000000000
10111010110111011100111111000110101011101110111111110100111101011111100010010110010001111111101101111
00100000000000000000100000000000000000100000010000000000100000000000000000000000000000000000100000000
11001111101100111111110000111110111101110110111110011110110100111111011011010101111111010111101011110
00000000101000000010000000000010000000100000010000000000000100000000000001010100000100000001000000000
10111101011011111110010110101110111110110101110011110010011111011111001011111010110110111110100110110
00000100000000000000000000000100001000000101000000000000000000001000000000100000010000000000000010100
10111011011111100101110001111110110111011111001111110100010111101111011100101011101111111011111101010
00001010000000000101000000000100000001000000000000000000010000000100010000000000000001000001000000000
01111011111001000110111110111101100001110111111111111101010101111101101111010111111011011011111010111
00000010000000000000000000100000100000000000000010000000010000001000000010000001000000010000000010000
11011101001011111010111011011101100101111110111111001101111110101100111011101110011111101101010110110
00010000000000000010000000000100100000000000010000000100000000001000000000101000000100000000010100100
11111110111000110101001011101101010000101110111011000111111110110011111100100011011100101111111111010
00000000000000000000000001000000000000000000000000000000000010000000000000000000000000000000010000010
10011111101010101111001011111011101101110111101100010111111111101011101111001110111000010111011011011
10000000100000000000000000000001001000010100000100000000000010000000000000000000000000000001000000000
11110001111001110110001000111111111101110111101011111111000110110110110101010110001100110010111111111
00000000000000100000000000000000000101000000001001000000000000100100000000000000000000000000000000000
11101101101101111111011000111011111000011111111011010111101011111110011111110110100111011110100011100
00000000100100001000000000001000000000000000100001010000100000000000001000000000000000000000000000000
11001011111100111001111101110111011111101101111101100011100011010011101111011101111100111100011101111
00000000000000100000001000100001000000001000100000000000000000000000000000001001000000010000000000000
10011001111111010111111001100101111011101001101101111010111001111011101111110101101111110110101111010
00000000000001010001000000000000000000001000000000000000000000001000000001000100000000100100000001010
11010111011011111011110101101111011101010011000111101111011110111110111110101110111011101011001101101
00010100010000100000000101000001001000000000000000000000000100001000010000000100000010000000000000000
10111011110110110111101111011001111011111100101010101111110011010011110111101111101110101110010111011
00000000100000000000001000000000010000000000001010000000000000000000010000000100000100000000000000000
11101010111111101011011111101000011111011111100110111110111001111111100001111101100001111011101011110
10001000000001000000000010000000000000000000000100000000100000001000000000001000000000000000000000100
11011110101011011110111010101000101010110011011111111010111101101101111001101111001011110110111111001
00000100100000000000000000000000000000000000000000000000100000001000010000000000000000100000001000000
01110111001111100011111101100101111110101111101010101101110110001111011101011111001111101110100011101
00000000000100000000000000000100000100100000000000100000000010000000000000000000001000000000000000100
11101111110110110111100111011111100110111101101110101111000101100110111011011011011001111001111101011
00000100000000100010000001001000000100010000100100000001000000000000000000000000000000000000000000000
10101101011111100111101111011111111111010011110000010110101010111011101111100001011110101100110111101
00101000000001000000100100001000000000000000000000000000101000000000000000000000000000000000000001001
11011110100111011010101011110101110111101111111110001111110011011000101010111111111011001110011100001
00000000000000000010101000010000000001000001000000000000000000000000001000000000000000000000000000000
