00000000000000000000110000000000000000000000000000000000000000000000000000000000000000000100000000010
11001011111001010110111101011011100111110110111101001111101001011011110111101011010110011001111110110
00000000000000000000000101001000100000000000000000000100000000000000010100001000000000000000000000000
01111110111011010111110011111110111111011111001011110111111011010011111101100010111110110011010011110
00000000100000010000100000001000001000010000001000010000000000000010000000000010000000000000000000010
01001111111100101111110101001011110011101101101100101101010111110110111001111110110001110010011011110
00000000000000000000000000001000000000000000000000000001000000100000010000000000000000000000000000000
10110101111001100110110110011111100111011101110111011101011011011111101100101101111101110011011011010
10100100000000000000000000000010000000000000100010000000000001000000000000000100001001000000000001010
01101110111011011111011011111011010111011111010111101101010011110110111100111101101101111001011110110
00000000001000000010010000100000000001001000000100000000000000000100000100000000000100000000000000010
01001101111100001011101101111110110100011110111111110110011001100010111100011110101111101011110111100
00000000000000000000000000000000000100000000000000000000000000000000000000000000000010001001000000000
11011110111101001001011010110110111110101111101101100100011111101101111011001111111101111011011100101
00001000010000000000000000000000000000000100000000000000000000100100010001000000001000000000000000001
11011110010110110111111000111011111000000101101111101110111011111100111100011111111101000111101111010
00000000000100010000010000000000000000000000000000000000000001000000001000000000010000000000000000010
01101111100101011110110110110100111110010111110111101010111101101111111011011111101001011111101111101
01000000000100000000000010000000000000000000100100000000000001000001000001000000000000000100000100000
01111011011010111101010101111110110101011100101110111110110111101110101111111011101011110110111010011
00000000001010000001000000000000000100000000000000000100000001000100000001000000000010000100000000000
11101101011001110111101011100111010101111101001111111010111011111010110110111011110111010101011011101
00000000000000010000000000000000010100000101000000010000000001000000000000010000000000000000010010000
11011011011011111011011101111011011110110111101011110111001111110011111010111111001110011100111110011
00010000001001000000010000000010010000000100001001000000000100000001000010000000000100000000000000001
01011010111011101101011011111000101111011110111110110111101111011101110110110110110110101101111010111
00000000000000000000001000001000000000000000000100000001000000010000000100000000000010100100001010000
01111101111100110101101101111111010011110101101111010111110010101111010111011110110101111011011101110
00000100000000010000000000010000000001000000000100010000100000000000000001000100000000000000010000000
10111011110101111101011101011000011110111110001101001110110110111000111101011111100101110110110100111
00010001000000010000000000000000000000000000000000000000010010010000000000000001000000000000000000000
10111110111011011101101011010111111010111101011001111110111111111011001110101110111110101111011111110
00000100001010000000000000010000000010010001010000000010000010000000001000000000100000100100000100000
11011011111010111111011101011101110100001011101110111111010010101111111011011001111101010110110111011
00010010000000010000010000000100100000000000000000000000000000000001000010000000000000000000010000000
01101111010101010011111111111000100110011111001110101110011001100111000111111100011011110100011111010
00000000000000000000000000000000000100000000000000000000000000000000000000000000000000000000000000010
01110011101111011111100111001111100011110110111110011101011110111100101111011010111100110010111111011
00100000000000010000000010000000000000010000000010000000000000000000000010001010100000000000000100001
10111110111101110011111111110101100111110111010101110111010100110101110111110101110111000110111001111
00000100001000010000000010000100000000000000000100000001000000000000000000000000010010000000000000000
01111011101001111111110110111100111001111101111011111010110001111111011011000101111101111101010111101
00000000101000000010000010000100000000000000010001000000010000000000000000000000000100100001010000000
10111110101110110111011111100011011011011010111101110111111100010101111011011010101111110111111010101
00000100000000000100000000000000010010001010001000100000000000000100010000001000000000010010000000000
10011110111101010111101111001100110111010111101101110101111111001111011101011111110111000011110111011
00000010010000000000000000000000010000000001000100000000001000000001000000000100000000000000000100000
10111101011110111100111111011011011111011110111101010111010101011101101011110110111101111011111010111
00000001000000100000001000001000000010001000000000000000000000001000000000010010000100100000100000000
10110101001101101111111110011011101101011100111111010001111101111110111011101011111100000111001110111
00000000000000000000100000000010000000000000001000000000000000100000100000000000000000000001000000000
10100111100010000101101111111001011010111100110111111010111111010101101011101110101111011011010110011
00000000000000000000000000000000000000000000000000000000001000000100000000000010000000000000000000000
01111011001111101011011110010110111110110110101010111110111101011101011000110110011011101011010111101
00000000000100000000000000000010000000000000100000000000000000000000000000000000001000101010010000000
10111110100110110111011111010101011011000111011111001011110111001011011111011110110111101011100111110
00100000000000100001000000000000000000000000000000001010000000001000000001000100000001000000000000010
01111111100111111101011110101101110111000111111111111010000110111010111110011111111010101101101111100
00000100000001000000001000000000010000000000010000000000000000100000000100000000100000000000101000000
11011100111001111011111100111101011101101111011100101111110111101010011111101000111110011111101001011
00000000010000000001000000100000001000000100001000000000010000001010000000100000000000000000000000000
10110111110101001001111111111001010111011110111100011011111011111011101011110110111101011110111101101
00000000000000000000000100000000010001000010000000000000001010000010001001000000100000001000001000000
11101101111011011001111010111101110111101011011111101000111101110101101010111111001101101011101100111
00000001000010000000001000000000000010000000000000000000010000010000000000000000000000001000000000000
01110100111011100110111101011110111110011101101011011011111100111000111011001011111110100011110001111
00000000000000000000000100000010000000000000001000000000000000000000001000000000000000000000000000000
10110110101001111110101010111111011101101001111011011111100101111010101111110111010111111110011011110
10100000000000000000101010001000000001000000000001000000000000000000100001000100000000100000000010000
10110111110111110001111001001111011001100000101110110111010110101110111111010100001111111011101111100
10000000000000000000000000000000000000000000000000000000000000000010100000000000000000100000001000000
11001110110111011111001111101011101011011101110111110101011011111100111110111101011101111101110111110
00000000000100000100000010001000000000000100010100000100000000010000000000100000001000001000010100000
00101110101111011110110101101011111011111001101111010111100111010110110110110011011011011110111111010
00000000000000000000000101000000000010000001000001000000000000000000000010100000000000000010000000010
01110101101100111111111101101000111011110001001111101110011101111100101110111010011010111010001111011
01000000100100000001000000000000000000000000000000100010000000000000000010100000000000000000000000000
11011101001111111111011111001111101001111111101111100110110111110011101111101110001111110101011010110
00000001000000010000010000000100001000000001001000000100000010000000100000001000000000000000000000000
00111001111111111101101001010110111101101111101010001111101111101100110011111101101011011111011100111
00000000000010000000000000010100000000101000000000000001000000000000100000000100101000000100001000000
11101101111100111101011111011111001011000010011111101111101110000111111101111011100110110101110110011
00001000100000000001000001010000001010000000000000000000000000000000100001000000000010000000000000000
11110101110011110110111101111100111011100111011101001100010111111101011101111100111011111101101110101
00000000000001000010100000100000010000000000000000000100000000000000001000010000001000001001000000000
10011111011010101110101111011110111011110011110110101111000111001111001110111010101110101001100111111
00000000001000000000000001000000100000000010000000000000000000000000001000000000000000101000000000001
01111011110111111011101001101001101111110111100110111101101111110110001011110011101011111101101101110
00001001000001000010000000000000000000010000000000000100000010000000000000000000001000001000000000010
11101011100110111011100101011100111110011001110101111001111101011010111010111101011101111101111101101
00000000000000000000000000010000000000000000000100000000000000000000100010000100000000010000100000100
11101011101101000111111011110110110101111100111111110110001111111111101101011001110110011100101101111
00000010000000000000000001000000010100000100000001000000000000010000000000000001000100000000000000000
01011111110111111000100111101101111101011110111011111101001111010111001001111011110110111111011010111
00000010000000000000000010000101000000010000000010000000000100010100000000000000100000010000000010000
11100011111110100111100111111111001100110100101111011011110111100111111101111100111011111001001111010
00000000010000000001000000000000000000000000001000000010000100000000100001000000010010000000000010010
11010111011011111001111011010111110001010111101110101111010011111111101101101100100111101100011100111
00000000010001000000000000000000000001000000000100100001000000000100000000000000000000000000000000000
10111100111111110101111010111011101111110111100101110111111111100100110111010111110110111110110010111
10000000001000000001000010100000100001000000000001000010000000000000100010000000010000000000000010000
