00000000000000000000000100000000001000000000000001000000000000000010000000000000000000000000000100000
01100111101101111110110110001011101101111010011111011110101101000011111111110101010111101111101111110
00000000000101000000000000000000100000000010000001001000000000000000000000000000010000100010000100000
00111111101011110101111011011110001101011011010101111101110111101101000110101111111101101111001111010
00000000100000000000000000000000000000000000000100010000100010000000000000000000010001001000000010010
01101111001111011011110101000010011101111111101000011011011011111111101111001110111011100010111110111
00000000000100000000000000000000000000000100000000000000000000000100001000000000010010000000000010000
10110001111110110111110010110110110001110110110111011101111101101010011111111011010101111110111101111
00000000000000100100000000000010010000000000000000000001000000000010000000100001000000000010000100001
01011101110111111100111100101001011110110001100101111101011111110111000110101111011111110100111010111
01000000010000000000000000000001010000000000000000000001010000000000000100100100001000000000100000001
01111111001101111011011011011110111111001110101111110111001010010011111111011110101011111011111011100
00001000000100001010000001010000010000000100100000000100000000000000000000010000001000000010000000000
01011110111101110101111111011111100110101011011111111011011111110111111010011100001011111110110110111
00000010000101000000001000001000000000001000000001000001001000000000000000000000001000010000100100000
10111011001111101111011110100110110110101110011111001101111101101011110011111001001011011111111011101
10001010000000100000000000000100000000000000001000000000010000100000000000100000000000000001000000001
11110001110001011101001101011110011010111111111001101101111100011011110110110100110111011110111011010
00000000000000000000000000000000000000000010000000001000000000001000000100000000000000001000000000010
11111001110111101101101010111001011111011100111101001111010111010111101101101000011110111101110111011
00000000100001001001000000000000000010010000000000000010010001010000000100000000000000000000010100000
00111111101110110111111101011111010111110011111010110011100011100111111001110111110111010101001111111
00000001000000000010000000010000000100000010000000010000000000000000000000000000100010010000000000000
01111101110111010110100100111011110111011011111001110111010011011111110010101111101101010101110001111
00000001000000000000000000000000010000000000000001000000000001000000000000001000000000000000000000001
01010101101001111001110110111110111101111101111010111000101101111101110110100111110111101010111011101
01010100000000000000000000000100010000010001000000000000000000010000000100100000000000001010100000001
10101010111101100111101111011101101111001111111001100111011101111100110010111010010111110110111100111
00000000000000000001000010010000001000000100000000000001010000100000000000000000000000000010000000000
11101011010101101011111101000111100111100110111110111001110011010101011001101111011111001110010011110
00000000000100000000000000000000000000000100010000000000000000000000000000000100000000000000000001000
10011110111110111110001011101101101101011101101001001100000101111111011101100111111111101111000111011
00000010100000000000001000000000001001001000100000000000000000000000000000000000000010000000000001000
10101111000011110111101111101101101001110111011011110101011111011011011111011110111111110100110111101
00000000000000000000100100000000000000010001000000000100000001010000000010000010001000000000010000000
01011111101110001010101110011111111111110100101000101100111111110111111111001011100111101010001101110
00000000100100000000000000000000010000000000001000000000000000010000100000000000000000000000000000010
11101001101011011100111111011111111100110111100010000110001110011111110101111110011110011001111100111
00000000000000000000001000001000000000000000000000000000000000000000000100100000000000010000000000000
11101101111110011001111110101110011110110101101111001111011110111011110111011101011110110101101111110
00000101000000000001000000001000000100100000000000000010000100100000000100000101000010000000000010000
01101110101011101001101101111111000011111111001001011111111111011011001101101110011011111101101011111
01000000101000000000000000001000000000000010000000000000001000000000000000000000010000010000100000000
10001001101111111110111111100111101011011010101111010111011010011011111101101010011101101010011111011
00000000000000000100000100000000101010001010100000000010000000000000000000000000010000000000000000001
01110111100110101110010101111110111011100101011110101011101100110100101111011110101110011101011111110
00000000000000001000000000000100001000100000000000000000000000000000000000000000100000000000000100000
11100101011110011110011011101111110001001111011111101001101101011101011110111101011110010111001110111
00000000000000000000000000000000000000001000001000000000000100000000000100000001000010000000000000000
11101111100100111101101011011100111111010111101110100101100100111111111110101101011010110111111001101
00000000000000100000001001000000000100010100000000000000100000000000001000101001001000000000000000000
11110001111101101011111111100011101111011110011101011011110011011101101110011101001101111111000100111
00000000010000101000100000000010000000010000000000001000000000000000001000000101000000000000000000000
01110111011110100111110001111101011011111100101111110011011110001110111111011110100110110011011111101
00000000000000000100000000001001000000001000000000000000000000000100010000000000000000000010000100000
10111101011101110111011011101111110101111001101111101111011000111100111101101100111101111011110001001
00000000010001000000001000100000100101000000000100000100000000000000000000000000010000000000000000000
01001111111011111111101011000101111110001000101010110010110111111110101111010101100010011101111001111
01000000001000010000000000000000000000000000000000000000000000000000000000000000000000000000010000000
11100111011011101111111110001101101010111110111110011001111101110101011011101011011111100010111101011
10000000001010000100000000000000000010000010000000000000010000000001000000000000000000000010000000000
01111100010111011011101111111001101100011011010111010101110111000101111101111011001101110111101101110
01000000000000001000000000000000000000000000010100000000000000000000000101000000000000100000001000010
01011110111111100111001001001111100111011001111101111110101111001100011101111101111101111010111101101
00000010000000000000000000000000000000010000000101000000001000000100000000000100001000000010000001000
11010110111001110011011111001111010101111010111110111110111100011111010110111101011111110101010111011
00000000000000100000000001000000000000000010100000100000000000001000010100000000010000000000000100000
10101100111111101111010011111001111100111011101010001110110011111111111010101111010111110111100111001
10100000000010000000010000000000000000010000100000000000000000000000100010100001010001000000000000000
00111010111000010111101011011111111000111100100111000111111111100111111100110011101110110111011110001
00000000000000000000000000000000100000000000000000000000000000000010000000000010000000010100000000000
10110111101011110110111100100101111111111100101111110101111010111111001110111010011110101111001110110
00010000000001000000100000000000000100000000100100000001000000010000000010001000000000000000000000000
11101111101101110101011111111011111010110101011011101000101111111010011110101111100111011001111011110
10001000001000100000000001000010000010100101010000101000000000000000000000100000000000000000100010000
01110110110101111000000111111001111111001001011011111111001110101110111101011101111001100111111011010
00000000010100000000000000000000000000000000000000001000000010000000000001000101000000000000010010010
01110111010111110110110101111101001111110110111110011011001111001111111110011110101011101001110111101
01000000010000000100000000001001000000000010100000000000000100000001000000001000000000000000000000001
11110101100101011010001101101110011111110001111110101011110111011101111000111001111110011111101110111
00000000000101000000000000000000000000000000001000101001000010000000000000010000001000000001000100000
11011011101101101111101101110100101110111111010110111111110011100110111111010010100010110110001111111
00001001000100000000000000000000100000001000000100000100000000000000100000000000000000000000000000000
10101011110110111010110011100111111011110101111111011011011001110010110110110111111011001111111000111
10101000000000000000000001000000100000100100000100000001010000000000000000000000100000000010000000000
10110011110011101110101110110111001101001111100010101111100111110010111101110010011011011111111101101
00000000000000000100000000000000001000000000000000000000000000000010010000010000000000000000100000100
11100011111101001011111001111110111111101110011110111010111110011101111010110111110111011111001011110
00000000000000000000100000000100001000001000000100000010000000000101000010100000000100000100000000010
11110011101101010111110110011111101110101101001111110110110110100001110111011111110111011011100111110
10000000000001000000100000000001000000000000000010000000010000000000000000000001000000000000000100000
01101111101110100011001111111110110101111111100001110101100111011111111001010011101101111110101101011
00100000000100000000000000000000000001000000000000100000000000000100000000000000000001000000001000000
11110011100111110100111111011101110011111111110101010100110100110101111101111101101110010111011101011
00000000000100000100000001000100000000001000000000000000010100000000000100001000000000000001000000000
10101111011000111101110110111001111101001111011011111100110110001110111101111010111101011101111010110
10000000000000000000000000100000000000000000010000000000000000000000010000010000001001000000100000010
10111000110111101111101100111100101100000101111101110110111101101010111110111101111010110111101001111
00000000000000101000000000000000000000000000000000000100010000100000000010010000000010100100000000001
01101111101111101100010111011101111010111001011011011011011101101100101111111010011010111101011101011
00100000000000000000010000000100100010100000000000000000000001000000000000000000000000010000001000000
