00000000001000000000010000000001000001000000100000000101000000100000000000110000000000000000010000000
11011100101001100110011100101011111110111101111101111110101101110010011101101110110111011111110110111
00000000000000000000000000000000000000001000001000001000000000000000000000101000010010000010000010000
11101111101110001001010101111010111111110011011011101011110110011101110111111000100111101110101111110
00000000000000000000000000010000000010000000000010001000000010000000000000000000000000001000000100000
00101100011111111110011100111111101101011111000111111101101111101011010111101011011100101010101111011
00000000000000000000010000000100001000000001000000000100100001001000000000000000000000101010000001000
11011000111101111101101100111100110010111010111001111011101101011111001110101010101111101010111010111
00000000000000100000000000000000000010010010100000000001000100000000000010000000000000000000000000000
10101111011101011011100001111110011110011011111001101110001011001111110010111111011001110111100101011
00000001000000000000000000000000000100000000000000000000000000000000010000000001000000000000000000000
01011111111011011010111100101100110001111111010011010111001111110000011111111101011111111100101100100
00000001000000000000000000000000100000000000000000000000000010000000000000000001000000000000000000000
01110111101110111101010111011110110111011110101111101101111000000111101011111111111011111010101111101
00000000001000100001010000000010100000001000000001001000010000000000000000000000010000000010101000001
00111110111011011111110111011010111111100111011110011110111101110010111111111101100011001001101110111
00000000000001000100000100001000000000000010000000001000000000000010100000000000000000000000100000001
01111011011100111111000011110101111111010011001111111010011111111100111101101001111101110110101111010
00000000001000000001000000000000000000010000000000000000000010000000100000000000100000000100000000010
01111101001101111111111100010000111001110001001111110111110111101011011110100011000011111111101011101
00000000000000000000000000000000100000010000000000000000100010000000000000000000000000000010000000100
10111111100110011101101001111010111110110101111100111111011011110111101100101111110011011101010101111
00001000000000000000000000000000010000000100000100000000001001000100000000000001000000000001000000000
11011101110101110101011101011111010110101101101101101011101111010101111111011011111111010011100101011
00010001000101000000000001000001010100000000000000101001000001010000001000001001000000000000000101000
01110100111011111001110110101111101001111011101111000101011110101001111011110101111011010111111101110
00010000000000001000000000000000100000000000000000000000000010000000000000010101000010000000010001000
01011110111011010111101011010110110001101000110111011111110011001101101011111011001111100011011011101
00000000000000000010000000000000000000000000000000000000000000000000000001000000000000000001001000000
01111110110110001001110101111010110111000111110111101011110011101011010101101111001100110110011111101
00000100000000000000000000000000000000000000000010001000100000000000000000000000000100000000000000000
01011111011001110110111111011110110111110001001011111111110111110110111001011110100111011101111110011
00000000000000000010000100000000100000000000000000000100000100000000000001010000100000000000001000000
01011111101011111100101111011111011111101101110000011111001011110110110111011010110111011011111010110
01000000001000000000100000001000000000000000000000001000000000000010100000000000100100000001000000010
10011111011010101110101110011101100111110011001111101001101110101111100110111111011010110101111100110
00000000010010000000000000000000000000000000000100000000000000001000000000010000000000100101000000100
01111101110110101011011111001011101111001110011110011100111110111110011110110111010001101111011101101
00001000000000101000000000000000000100000000000000000100000000010000000000000000000001000000010000001
11101010100001111111101101101111011011111010101111001111101101110011101110110101111011010111100110111
00000000000000000000001000000100010000000000001000000010000101000000000100000000001010010010000000000
11111000011110111111011010001111101011001101010111111111001110110111101101111111001011101111100110101
00000000000100000000000000000010000001000000000000000000001000000001000101000000001000000100000000000
10111010110110110110111001011111110110111110110111010111101101101110111100111111011110101111110011101
00000000000000100010001000000000100000010000100010000000000000101000010000000100000100000010000000000
01101011111111111010011111000001111111011111100101110001001010101101111101101110101011011111111000110
00000000001000000000000000000000100000000000000000000000001000000000000100000010000000000000000000100
01101110011101110110100101101101011010111010110110110001101011001101001001011111011011111111100110111
01000000000000000000000000000001000000000000000010000000000000000000000000000000000000000000000100000
00111011111101001111101110110011011111110001111001011011011111011111010101111010011111011010001111110
00000000001001000000100000010000000000000000000000001000000001010000010000000000000000010000000000010
10111111110011011010101100111011011101101011111011111111110000011011101101110111101111011101011011101
00001000000000000000101000000000000000001000010001000000000000000001000000010000100100000101010010000
10111011111011011110101011111101101110101011011011010010111111001111011101111001110011101011011101111
00100000100001001000000000010000100000000000000000000000000001000000000101000000000000000010000100000
11011111101011111011111011011110011011001110101010111110110011111111010110010111011011111010111101101
00001000001000100000100010001000000000000000000000000010000000000000000000000010010000000010000000100
11101110100111110100111111001100111010101111110111001011110110010111011110111011011110111100111101011
10000010000000000000000000000000000000100001000000000000010000000000000000010010000100000000001000000
10111001101110110111111110111100001011001101011010111110110111110110101110111100111111001111111110001
10000000000000000100000000000000000000000001010010010000010000100100000000001000000001000000000000000
01101111110111011010111010111010110101110110110110110111110101111010100100110111111101001111010111110
00100000100010000000000000000000010100000000000000100100000001000000000000000000000001000000000000000
01111011010011111010111101110101111011001011111110100111100011001111110101010110111011110111010110111
01000000010000001010000100100000000000000001000000000000000010000000000000000000100000100010010100000
01111010101101110101101111011011010111101110101010111011010110111111011011101100111011110011001111110
01000000100000000000000100001001000000100000000000000000000010000010000000000100000000000000000001000
01011011110100110111110011111101110111101001111110101111101010111110101111111011101011110101000110110
01001000000000000001000000010001000000001000000000100000001000000010000001000000000000000000000000000
01111101111010110110010111101110110110111101110101010111101011011110001001111101110101111101011110110
00001001000010100000000000000000010000000000000000010010000000000000000000000000100000000100000000000
01111011101011011111110101111010000111111011011101111101011010111110110110111110100101101100111111001
01000010000000000100000001000000000000000000001000100000000000001000100000000000000000000100000000000
01110110110111111011001101111101110011100110000111111110110111101101101110110101111011110101111011101
00010010010000100000000000100000000000000000000000001000000100001000000010100100100000100000000001000
01011110111110010111011111000110110101010111011011011110111101010110111101110101011110110111110011110
00000000000000010001010000000000000000000001000000000100100001010010100000100000000010100000100000010
01101110110111101011110111111100001111011110100111111011011101110111111110011011110111101111101111100
00000000000010000000010000000000000010000010100000010001001000000001000000001000000001000010000000000
11001111111101100110111110111110110111100111110001101111011101100110111111011010000101110010111110111
00000001000001000000000100000100000000000100000000000000000000000100000100000000000000000000000000000
11010111101010111101101001111011111011101100011010110010111011101110111001111101101111111110000110101
00000000000010010000000000001001000000000000000000010000000000000000000001000000001000000000000000000
10111111010001111110101011101100111001110110101111101110111011011111111011011101111110110101010101011
00000000000000100000001000000000000000010010100100001000000010000010000010000001000000000000000001000
01101111011110111100011100001111011110101110110101111100101110111110011111011010111010100011001001011
00000001000000100000000000000000000000000000000001000000000100000000000000000000000000000000000000000
01111011110101110101111111111000111000111111011111110011101101111111100111110011100011101100101110111
00001001000000010000000100000000000000000010001000000010001000100000000100000000000000100000000000000
11110011010111011111100011111110011101111011001010101011101011011000111101110011110111101101011010111
00000000000010000000000001000000010000000010000000000000000000000000000000000000000000000001010000000
01110111110111011110111101111111111010101001101011110101111110110111111011101110001100111111100111101
01000010000100001000010000010000000000000001001000000000010000010000010010000000000000000001000000000
10110111011111011110111100110000101111101101101111111000011111111011110010111011100011111011001111101
00010000000010000010000100000000000000000000000000010000000000000001000000000000000000001000000000001
10101111101101010011110011010101011011111101010110101111110001011101011110011110111010110011111010111
00101000000001000000000000000000000000000000000010000000000000000100000000000100010000000000001000000
10101100111111001110100011110110011111110111111111010010010111100011111011100101101111010111101011011
00000000000100000010000000000000000000010000000000000000000000000000100000000000100000000001000000000
11011111100111110010100000111011001111111111011001111010111001111110110011101101100011011011101011110
00010000000010000000000000000000000000000000010000001000000000000000000000000000000000010000001010000
