00000000000100000000000000000000000000000000000001100000100000000001010000000100000000000000000000000
01100101101111101110110110111110110001011101111100010110111101011101110101010111101111011011111110110
00100000000000000000100000000000000000000000000000000100001001000000100101010000100000001000001000010
11000011011111011110011110110011011011011101001100111101100010011111111111000101101110010111011110101
00000000000000000010000000000000000000000000000000000001000000000000000000000100100000000000000100100
00110111101010011101101111001111110010110100100101101111101011011111000100011111010111101101110111110
00000000000000000000000000000000000000000000100000000000000000000000000000000000010001000000000100000
11101111110011110111101011101101101111011010110111110011111101110110100111110111010110111111101111001
10000010000000100010000000000000100100000000000001000000010001000000000001000000000010000010000000001
00010110110010110111111011011111110111011101011011011110101101011111101010110110111010110111011111101
00000000000000000000000000000010000010001000000000000000100100000000101000000000001000000000000100001
11111100110100101111101101111101101101110101000111110011110110011111111010111100001110110110111001111
00000000100000000000100100100000001001000000000000000000000100000001000000000000000010100100100000000
11011110100101011101111010101111111001000111111010101110110101101111010111101100101100001111111101101
00000000000000001000000000000010000000000000000000000000100000000000010100000000000000000000010000100
10101110101111110001110101111011111101101111011110110001111111011011101100101110011111001110010101111
00101000000010000000000000010000100001000100010000100000000001001010000000000000000000001000000000000
10111110110010111101110111110010101010100001011101011111101111001010111101101110111101111011110010101
00100000000000010000000000000000000000000000000000000000000000000010000000100000001001000000000000100
10111011111101001001111111100010001011111110101101110110110111010110011111011100111011111100111001101
10000000000000000000100000000010000000000010000000000010000000000000000001000000000000100000000000000
11011011100100111111111101110111010101110111110110101111011101101110001101110101111110011110011110001
00000000100000000000100001000000010000000001000000100001001000000000000000010000000000000000000000000
10100110110001001111111111111100110101011111111110000111011010010101101111100110111110001110101101111
00000000000000000000000010000000000000010000000000000000000000000000001000000100000000000010000000000
11111111000011110110110111111100010011111101110110101111111011101110110111101011111110010100111111001
00000000000010000100000000000000000000100000100010000000010001000010100000001001000000000000001000000
10111111011111100110111001110110110110110011111100111101011110101111110001111101111011111001110011111
00010000010000000000100000000000010100000000000000100001000010000000000000001000001000000000010000000
01011111010101110101110110000101111001111011111001101111110011101101110111011100001011111101111010110
01000100000000000000000000000000000000001000000000100000000000001000000001010000000000000000000000100
10101111111101111001001101110101111011011010111011011011011110101110011111101111010111111110011101111
10000001000001000000000000000000000001000000000001001001000000100000000010000100000000100000000100000
11101110101011101110111010110111011010111011110011011011111010101010111011111010111011101011110110010
00000000101000000010001010100000000000010000000000000001000000000000001000000010010000000000000000010
01111001111011101101110110110111101011101010101110111011101111110010111011110111100110110110111001111
01000000010000100101000010100000000000000000001000010010000000000000100001000000000000010000000000000
10111100111101011101001111111011000101111111110110001011101111101110111111110110011110111011011101110
00000100000000000000000000100010000000000000000000000001001000001000001000000000010000010000001000000
01111001101101111000111011110101111001110100011111011111101111000101101111110101100101110111101100111
01000000000100010000000000000000000000010000000000000000000000000100000000000001000000000001000000000
11011111011011111000010111110111001111011101010111110111101010101101110101111101011011001101101010111
00000100010000000000000000010100000010000000000000100000000000100000010100100000000000000000001000000
01101100111110111111001101101111101101110111101101111110101011011110111111110100111101011101111111001
00100100000010000010000000000000101000000010001000010000101010000100000100000000001000000101000000001
01011110100111111110000111111111110010111010100110101100011111010001011111101110111101111001111010110
01010000100000000000000000100000000000000000000000000000000000000000000100000100100000100000000000010
11110011111101111001111011100010111111100110111110111001110111101111010011111111011110101111011101011
10000000010000010000000000000000000100000010001000000000100010000010000000000100001000100000000000001
10111011111110010011110011101111011111110011101000001001011111110110111011101100101111101001011111110
00000000100000000000000000100000000000000000000000000000000000000100000001001000000000000000000001000
11101101000001101011101011110111011110001111011111001000001111110011101110110101111001101011111010111
00000000000000000000000000000000000000000000000000000000000000000001000000100100000000000000100000000
10101110111110110110101111101111110100111101101111101101111011100010111111101110111110111101011101110
00101000100000100100000001001000000000010000000100000100000001000000000001000000001000000000010000100
11101101101010100100111111111111010111111011111000011100010101111001110011111011111001001001101111011
00000100000000000000000000000100000000000000000000000000000001000000000000000000000000000001000100001
11011101111101010111011101101010110111111111010101110110111010011111111110100110010101111011111110101
00001000000000000100000000000000010000010000000100000000001010000000000000000000000100000000100000000
10111110111010011111110000111011110111110010101101111110011111110111001011111101000011111101110111011
00000000100000000000000000001000000000000010000000001000000100000100000000000000000000000001000100000
00011011110100110111011111101111011101101111101101101010111101110111111011001110000110111001111011011
00000000000000000000000001000001000000000010000000101000000000100000000000000000000000010000000000000
01111000010101000101100101111101111111111101101110111101101000111001110111101101001010111101101010110
00000000000000000000000000000000000000001001000000000000000000000000010000000000000000000000000000000
00010011111101111101111011100111011011010101111111101001100010101000010111111100110111111011011110101
00000000000000000100100000000000000000000000000000000000000000001000000000000000000000010001000010100
11001110111011111101100101111111101100111111011011101111001111011001110111111100111110110100101110101
00000010001000100000100000000010001000000100000000100000000000000000100001000000100000000000000000000
11101110100110001101110101101000111110111110111111001110111110101011001111010100001011111111011110101
00001000000000000000000000000000000000000000010000000010000000000000000000010000000000000000000000000
10011011111011111101110110011000110001110001110110111001111110110111000111101111110101010110101010111
00000000000010000000000000000000010000000000000000000000000000000000000000100000000000000000000010000
00011111110110111011110110110111110111100101101101111011101011111101101111111011011101110111001111010
00000000000000000010000010100001000000000100000000010000100000000100000000100000000001000000000000000
10110110001011101011011111111111110001101010111011010111010101011101101101111101011010111101111011110
00010100000000000000000000100000000000000000100000000000000001001000100000000100000000000000010001000
11001111101101111011111110101100001111011011111001110000110111111001111011101011110111001101111101101
10000000100101000001000000000000000000001000000000010000000000000000000001001010000000000100000101000
11011111110101101111111101100101111110011110111110100111110101111000111100011111011110101001110101110
00000100000100100001000000000000100000010000010000100000000000000000000000000100010000000000000000000
11110111111100001101011111101001101000011011110100001011110111110111001001101111110100111110101111110
00000000000000000000000000000000000000000010000000000000000000000000000000000010000000000100100100000
11110110101101101111101111011111011001001111001110101101111111001101110111111100111101010111111100111
10000010100101000001000010010000000000000000000000000100000100000000000001000000000000010001000000001
00100111111110100000111110111101111001111010110110110111111111110111010010100110001001111110111110101
00000000000010100000000000000000000000000010010000000000000000000000000000000000000000100000100000000
11110110110110101110011110001011111101111110010110100111111110110010111010111101011110111010111111001
00000100000000000100000010000000000000000000000100000000010000000000010000001000000000100000001000000
11010110101010111110111110001011101111011110111111001001111101011001110110111101111011001101111111100
00000000000000001000000000000000000100000100001000000000000001000000000000000100000010000000001000000
10111110011010111110101110000111110011111111001101110111110101011011101111011011101110010111111101010
00000000010000000000000000000000100000010000000100000000100000000000100000001000100100000000000000010
11011111011011010111101110101001111011011110101111100110011110100111011000011111100011110111100111011
00000100010001010001000000000000000000010000000000000000010000000001000000000000000000000000000001000
11101110111011101111101010111111111101101100110011001101000011111110111110011111100011011111011011110
00001000100001000000001000000001000000000000010000000000000000000000000000000100000000000010000000010
01011011101011011100111010111100101111100110111111111110001100011010111111010101010111100111111101110
01010000000000000000100010001000000000100000000000000000000000000010000000000000000010000000010000000
10110110111111010110111011100011111110110110111110011010011101111101101011011101101011100101111100111
10010000000010000000000010000000001000000100000000010000000000000000000010000100000000000000000000000
