00000000000000001000010010000000000010000000000001000011000000010000000000000000100000100000000000100
10101011111110000111101111011100110111011100111110010011111110111111010111100110001110110011110111110
00000000000000000001000001001000000000001000000010000000000000000000000000000000001000000000100000100
11011011100011111111010011010110111011111001110101101011011110011101101110111001001101111011101111011
00001000000000000000000000000000100010000000000000000001000100000000000000000000000000010000000100000
11011000111101111111001111100111010000111111111000101111001101001111111110101010111111100001111111110
00000000000000010000000000000000000000000100000000000001000000000000000000101010001000000000000010000
10111101111111110001011101011101010110111001111110101111001111111101011111010100010111100011010111101
10000100100000000001000000000101000000000000000000100001000000000000000000000000000100000000000000000
11010101111100111110110111100101111101011011101010101111101110111101101011101111011101110111110111110
00000000000000100000100100000000010000000000100000000000000010000000001000000010000000010000000100000
10111010111111001101110001101111110111110011110100100111000111110011110111101101111111100001111100010
00000010100000000001000000000001000000000000000000000010000000000000000010000000000000000000000000000
10110110111110001110101100111110110111110101101101110111101011101010111101011101011111110110110101010
10000000000000000000001000000000010010000000000001000000001000000000001000000000000010000000010101010
10111101101011101111111111010001010111111001011110111110101011011110111001010011001111110111111100110
00100000000010000100000000000000000010000001000010000010101000000000000000000000000001000010000000010
11101011001111111010110010101110101111110111111111100001011111100010100101111111010111001001011011111
00001001000000001000000000000000000000100001000000000001000100000000000000000000010000000000000000000
11110100100101111111001011101101110101110101010111100011011011110110111001111110111101101110001111101
10000000000000000000000000001000000000010101000000000000000000010010010000001000000001001000000000000
01111110010111101111011111010010111100111101111000111011100110011110101011110110111011011110001110111
00000000010010000100010000000000010000001000000000000000000000000010101001000010001001010000000000001
01110100110110111100110011111100101111111101111011101011101011011111101010101110111011011001101111101
01000100000000000000000000000000100001000001000000000010000000001000000000100000000000000000000100000
01011110111011110111101101101110101101110001110111110011010111011110101111010100101110000101111111101
00000010010000000010000001000000000000000000010000000001010010000000000000000000100000000000000000000
10110011011111001100111111111011011110111110011101111101011101111011111001100111001110111010111010111
00100000000010000000000000100000001000010000000100100000000101000000000000000100000000000010100010000
11011101000100111101111011010101111110111011011101011011111010000011101111111111111010111001100000111
00000101000000000000000000000000000000100010000001000000010000000000000000000000000000000000000000000
10001101011001011111111101111111011000100110111111100111001000111110111101110011111101011110110111110
00000000000000000000010000010000000000000000000100000000000000000000001000000000100000010000000100000
11010111101011111110011111101101100011110101110100011111111010011011111110111101110110101010110111110
10000000001000001000000001001000000000000000010000000000010010000000000000100000000000000000010000000
00100110111111110101110100101111111011101011110111111001011001110101111011010101111011111110011101110
00000000000000010000000000000000001000100000010100000000010000000000000000000000010000010000001001000
01111011101011000100111111101100101011111011101011011100111111100111111011101111011110011100011010111
00001001001010000000000000000000000000010000000001001000000010000000010000100000000000000000001000000
10111011111101110111110010110010010111101100110111010011111110111110100101010111011111111001101011001
00001000010000000000000000000000000000100000000000000000000100000000000000000000001000000000000000000
10101101101111010011110101010111110011011101111101100000111110111011011100011110101110111011110101110
00100000000000000000000001000000000000000101000000000000000000000010000000000000000010001001000000010
11010011111011111001111011100101001101101100100111111111001111110101001110110111110011001001111101111
00000000001000000000010001000000000000000000000000000000000000000000001000000010000001000000000000000
11110110111010110110110111001110111101111011101011110101100110111001111101111011110111010011111101110
00000000100000000000100100000000001000100000001010000000000010100000000100000001000010000000001001000
01111001010111110010111000010111000111111001000111011111111011111111110101100100011110011111111101011
00000000000000010000000000000000000000000000000000000000000000001000000000000000000010000000100001000
11010111101011011101011010110010111110101100010001110111011011011111011001011111100100101011110111101
00000010001000000101010010000000000000000100000000000000000000000000000000000000000000000000010010000
11110010111011101111001101111111001010101110011111011111010100101111101001110011110111011011011110110
00000000001000100010000000000000000000000100000010000100000000000000100000000000000000000001000010010
11101101110011100011100111111011100110011111111001111011011100111011101110111111010111100011011111110
00000000000000000000100000000000000010000001000000001001000000000000100100001000010001000000000000000
00110111110001001111110110100111111011111110001110111101010111110101101000111011111001010111010111110
00000000000000000000000000000000100000000000001000000000000100000000000000000000000000010001010000000
11111010011011111010110111000111011110100111100111101010111010001011000111111111011110111110101111110
00000000001001000000000000000000001000000000000000000000010000000000000000000000001000010000100000000
01011111011101110011101001111011011110111010101110001110110111011101111110110101110010111111011111010
00000001001000100000000000000000000000100010100000000000000001000000001000000100000000000001010000010
11110111110110100101011110000100101111100111101101110110101101110111010101101111101101101111010001101
00000000000000000000000000000000000000000010000001000000000000100010000000000000000000000000000001000
01100111110111011101111110011110111111101010001101111110010101011111110011011011111011101110110111110
00000000010000000101000000001000001000000010000000000000000000000000000000001000010001000010100000100
10101111011101111110011111111001100111101110111001011111100101101111001111011101111110000111110111001
00100010000000100000000100000000000001000000000001000000000100000010000000001000000000000000000000001
11001011011011101110111111010101011010111010111001100100110101001111101110111111100100011011000111111
00000000000000000010010000000000000000000000100000000000000000000000000000001000000000000000000000000
11110011110100110010111101111011011001010100111111110111111101010101101111010111101010110111011110101
00000010000000000000000000100000000000000000000001000010000000000100000000000100001000000000001000000
10100011101011111110111010101111011100101111001110111101101010111101111010101101110001111111101011101
10100000000000000000010010100000000100000000000000000000100000000000001010101000000000000010000000000
01111110110111011100111011100111011110111110110100111011111011101110111110101101011011111001101101101
00001000010000000000010000000000000100010000000000001000000010000000100000000101000000000000000001000
10111011111010011111010101101010111110101011101011111010111111100010111110011101011101101110001111101
00010000100000000000000000101010000000101001001000000010100000000000001000000000000000100000000000000
11111110001010100111100111011111101111001110011010111111011111100111110101001101101110111011110111101
00000000000000100000000000000100000100000010000000000001000001000000000001000000000000000000100000100
10111010001111011111101011100011111001111011001100101111100111010001111110001111111010101101111011101
00000000000000000000000000000010000001000000000000000000000000000000000000000010000000000000100000100
11110100111001111110110111111111000011111010101110110111000011111011001110001111101111101111011101110
00000100000000000010010010000000000001000000000000000000000000100000000010000000000001000001001000010
11111101001011111101010110111011111011011010110110001011110001011011011111111100101011101101101111101
00000000001000000001010000001000100000000000010000000000000000000000000000000000001010000000001000001
11111010010111110111110001011101001010111111101101101100101111000101111011110110101111110110011010101
00000000010100000000000001000000000000000000000000000000000100000000000000100000000010000000000000000
01111110110110111101110101111010110111111011010010101100110111000110011011110101111101111100111010110
00001000010010000100100101000000010100000000000000000000000001000000000000000000000100100000000000000
10101111010101111001101001101011101011110111011110101111010011111110001110111111110001101111010110101
00101000000100000000000000000000000000010000000100000001010000000000000000100000000001000000000000001
11010111101011010110011011100110111010010111101110001111101101101110101111011101100111110011111110110
00010100000000000100000000000000000000000000000010000000000000000100000000000000000100000000100000100
10111010111010110011111110011011111011000111111101110111011111101011001010111111001100011100011011010
00100000000010100000000000010000000010000000000100010001010000000000000000000000000000000000000000010
11100011000001111011101101111111011110001011110011111100100101111101110100101111110111011000100111111
00000000000000000000000000000000000000000010000000100000000000000101000000000000000100000000000000000
01111001111101101011101110111100011111110011110111010100011111111101101111101110010011011111011011011
00000000001001000000000100000000000100000010000010000000000000010001000000001000000000000000001001001
11110011001110110010101111111110011111111010101111100101011101110110110110111111100110110110110111011
00000000000000010000000000000100000000100000000000000000001000000000010100001000000000000010100000000
