00000000001000100000010100001000000000010000000000000000001100010000000000000000000000001000000100000
11010111111111000100101110101011101101101011101110011110110111111010110110100011000110111111011101110
00010000000000000000000100000000000101000000000000000100010001000000000000000000000000000000001000000
01000111111011011110110111111010110011110111011001111011110011111101011011101101011110111100111110100
01000000000000000100010000100010100000010000000000001000000000010000000000000101000100100000000000000
01011111111011011101100111110111011101111110110001100001010111111111011101101001111111010110111111100
00000001000001000000000000010100010000000000000000000000000000010000010000000000010000010000000000000
10111011100010111011110101101111110111100011110111100010111101110111101111010101111001101111001111001
10100000000000000000000001000010000000000010000000000000010000010010000000000000000001000000000000000
11011100111000001100111101001111110001011110111111111010110101011011110111110110011111110111010111110
00000100000000000000000000000000000000000000000000000000100000000000000010000100000000100000000010000
01011111010011100001111111110110111111110010011111001111000011010011111011011011110011111001111110110
00000001000000000000000000000100010000000000000000000000000010000000000001000000010000000000010000100
11011101011110110000101111111011101101111011010111011011011001111101111110110110100111111100101110101
00000001001000100000000000000000001000000000000100000000000000010000010000000000000010000000101000000
11101111010101101011110111111111101001100101000111110101011101111010111100111101111010111101010001110
00000000000001000000010010000000000000000000000000000001000000000000010000000001000000000000000000000
10110111010111110011111010111110110111011110110011111001101111011011101111001101111011101001111110110
00000010000000010000000000000100000010000000010000001000000000001001000100000000001000000000000010010
11001110101110101111110111110010011110111111101001101101111110100011010111110110101111000000100111111
00000000000010100000000100000000000010100000000000001000000000000000000000000000000000000000000000000
00111111110111000101101111110101101011111100101101111010101111110101111110011100101111101011011111011
00000000000000000100000001000101001000000000000101000000100001000000001000000000000000100000000000001
11010111011011111011100101110110111010101011111110011010111011110100111110110100110111111010111010111
00000001010001000000000001000000100010100000000000000010001001000000000000000000010001000000010000000
01111111001101101110000110001101111101011111101011101111111110100100010111110101110111101110010011101
00000000000001000000000000000000000000000000100000000001000000000000000000010100000010000000000000000
10110111111110011101101110101010100011111110110111110111011001110110111011101010101101101111101010110
00000000100000000101000000000000000000000000010000000100010000000000000000000000100000000000000000010
10101011111011101101011111111001110110110011011101101011101110011111111010110110111001101110111011110
00100000000000001001000001000000010010100000000000000000001000000010000000100100100000000010100000000
01110111101111011001101011111010111111110101110010011110101110110111101110110111110111101011110101110
00100001000001010000000000001000000010000000000000000100000010000000000000100000100001001010000000000
01011111011111010011100011011111110001101101101111101011110010011011100101111010110111111010100111111
01001000000000000010000000000000000000000101000100000000000000000000000000010010010000000000100000000
10111010011110101111110111101111111010010111011111011010011001111101100000110111111111011111110111010
00100010000000000000100000101000000000010000000000000000000000010000100000000000000000000100000100010
11101110111110100111011110111000111110111101011101111011100101111011010110111110110101011011011101011
00000100000100000000000100010000000000000101000000100000000000100000000000100000000001000000000001001
11111010110101011111101101111110111011111000011111100111111001111001111101011110111011101110111110110
00000000100100000000001000001000001001000000000000100000000000000000100000010000010000000100000100100
11011110110100110111101110110011100101111101101011111111101100011111001111011010111111001101111010110
10001000000000000001001000000000000000010000001000010000000000001000000010000000001000000100010010010
10100111111101001011111101101110111011110110111010110100111111101101111010111110110111001101011011101
00100000000101000000000001001000010010000010000000000000000100001000100000001000000000000101000000100
11100101101101110111110011101001111100110110011011101101101111011111010011011010100111101101111000111
00000000000100100000000000001000000100000000000000000000000000010000000001001000000000000000000000000
10111011111101101110100100111001011011001111111011001111101001111110101100101011110110111110111111010
00100010000000000000000000000001000000000000010000000000000000010000000000000000000010000000010000000
01010011111111001111110111101011111101110111000100111110111100110011110101100111110110011011111011010
00000000000001000000000010001000000000000000000000001000000000000001000000000000000000010001000000010
11011111111011001101101110011110111101111010111010100011110001111100101111111010101111101111001110101
10000010000000000000000000010000100001000000010010000000000000000000000000000010000000100000000000000
01011110101101101110111011001010111111111100111001111111010001010001011111100100111110111101111001110
01000000000000100000001001000000000000000000100000010000000000000000000000000000000000000100000000000
01101100101110100110111110110110111011111010101010111111010111111101101011110001101110111011110111010
00000000000000000000000000100010000000000000101000000010010001000000000010000000000010000000000100010
11110011011100001111110010111010111011001111101111000010011111011011110111011011011011011101111001101
00000010000000000000000000000000010000000000000000000000000000010010000000010000000001010000000000000
11010101111101110000110001101111110011111111110011011111010000110111011000101111111010001011111111011
10000000001000010000000000000000000000000010000000000000000000000000001000000000001000000000000001000
01111101101011101110101110011111010100111110111101110101010100101110011011101111111010000011011101111
00000000001000101000100010000000000000000000100000100101010000000000000000000001000000000000000000000
01010110011111011001111101101101101100101010111000111101100011111001111110101111101111001011010111101
01010000000000000000100000000000001000000000000000000000000000000000000010000000101000000000000001000
01111111011111001010111110011001110101111011101110011101111010010110111111110110110011111100111001111
00000100000000000010100000000000100000000000001000000100100000000000000010000000100000000000001000000
11011101101101011001100111111111011011101101101110111010110010111011111101011111110010011110101011011
00000000100101001000000000001000001000000000000100001000000000000000000001000000000010000000000000000
01001111101101111110111000101101101110001111111111111011100001110011101011011111010111110001001011111
01000000000001000000000000100000000000000000010000000000000001000000100000000000000100000000000000001
11011100101101111110101101101010001001111101011100111011011001111110101111011010111101010111111011011
00000000000000000000000000000000001000000000001000000000000000010000000010001010000101010000010000000
01111101101111100111011111110100110111100110110001111110101111001101111010010011001100111111101101111
00100001000010000001000010000000000000000000000000010000000000000000000000000010000000000000100000000
11101110111111111111100000101101011101110111110011111110100010011000101111100111011111011111001011011
00001000010000000000000000000000010000000100000000000000000000000000000000000001000100000100000000000
01100110011111011111011010011101111011100111011110101111011110101110011110111011111011101101101011110
01000000000000001000001000000000000001000000000000100000001000000010000000001000000010001001000000000
01101011011111011011011100111011010111110100111010111111010111101111010111110110110100111111111100101
00000000000000010010000000000000010000000100000000000001000000000000010100000100100100000010000000101
01010111111101111101101110101101011011101111001101101110001111110111011101101011101011101110111101110
01000000100000100000000000001000000000000000000000001000000000100001010000001000000000000100010001000
01111011100101110100111110110111101001111110101111011111111011001100101000101101110111010111110011111
01000000000100000000000000100000001000000100100100000000000000000000000000101000000010000000010000000
11011111000100110111010111001011110010001111101101011110011101100101000111111111110110011101010101110
00000000000000000000000000000000100000000000000000000000000101000000000000000000000000000000000100010
11100110111010101110010111011101100101110111101101110111010111010011100011101101111101001101011111100
10000000000010101000000000000100000000000000100100010100000001010000000000000000000000000000000000000
01111100111101011011010111111010111100111111101111011101101111101010111101100111101101001111001110111
00010000000000001001010000010000001000000001000010000000101000000010000001000000000000000000000100000
01101010111011110101111101001110110111011011011111011011011011111110111010111010110101111100111111011
01001010001000000100010000000000000010010001001000001001000000010000100010100000000000010000000100001
10111010110111010101110111011111100011101111100111101111010010111010111101111011110011110111011011101
00000000010100000000010100001000000000000100000000001000000000000000001000000010000000010001000000000
10110111010110111110111000111011110101101101111100010001111110110111111001111010011110110111111010111
00000000000010100000100000000000000000000000100000000000000000000001000000000000000100000000100000000
10101111011101011010010111110111111011011111111101000011011111010111100010101110111011010111000111110
00000010000100000000000000000001000000010000000000000000010000000000000000000000000000000000000100000
11011011111011001111001101011111011110100110110110011101111001011100110110111101110110001011011110011
00010000100010000001000000000001000000000000000000000000000001000100000000000000000000000000000000000
