00000000000010001000000010000000000001000000000000000000000000000001000000000000100000000000000100000
01110110111111000011111111100101001110101101000111111010110111101101101111100110011010010110111101110
01000010001000000000001000000000000000000000000000000000000010000101000000000000000000000000001000000
01111111011111011011100111010111100111110010110110110001011011111111001110111011011101101111011101101
00010000010000000010000000000000000001000000000000000000000000001000000100010000000100000010000000001
11101101010100011111011110111101111010100111011110110010111011110110101101101011111101100110111011110
00000000000000000000001000001000000000000001010000000000000001000000000001000000000000000100001000000
01101111110011011101111101010110110111011011010100111010011111101011111110110101011110111101101011111
00000000000001010001000000000010000000001010010100000000000000101000010000000001000010000000100000000
10110010111110111010101110101110111011111010101000101101110111111011011100111111101110111101111011101
00000000000000000010100000000000010000000000001000000000000000000000010000000010000010000001000001000
11110100011011111110101101010101101001110001111111011101101111101011011111011110111100111110111011110
00000000000000010000000001010000000000000000000001000000000100000000001000010000010000000010010000010
11001110011011111100111101110010111011100101111101010011011111101110010111001110111100101111011010111
00000010000000001000000000000000000000000001000000010000000000000000000000001000010000000000000010000
11101100111100111111001111110000111111010110001100111110001111001111100111110110011101111011010011111
00000000000000010000000000000000001000000000000000000000000001000000000000100100000000001000000000000
01111111010111111001101111101101011011111101001111001011001111110111110110110101101111101100111110110
00000100010000000000101000000001001000000001000000000000000000000010000000000100000000000000010000000
10111110010110111010110111001111010111101111001101110101011101111001101111100101010011000111111011110
00100000010100000000010000000000000010000000000000000001000000000000000000000001000000000000000000000
01111011111110001110100111101011110101011010100111011011010110111011111110011011011101011101111000110
00000001000000000010100000000000000000000000000000000001000000000001000000010010000000000000000000000
11011101110011110101101111001110110111001011100101111010010111110001011101110111011010111111010101010
10000000000001000100000000000000000000000001000000000000000000000000000000010001001000000000000101010
01111101110010101011101110110101011011101111101100111101011011011010110111011111010111011011111101001
00000000000000001010000000000000010000101000001000000101001001001000000000000100000001010000000000000
11011110110011111101111011101100111011101011111111110101000101011110111100111010111000111101110111011
00000100100000001000010000000000000001000000100000000000000000001000000000100000000000000000010100001
11011100111011010111100011011111011100111100101111010111111100100110110111110101011010110110111101110
00000000000000010000000000000001001000000000000000010010000000000010010010000001010010000000001000100
11111101001010110110111111100110101110110111110111101110110110110111010111111110100110001111110111011
10000000001000000000000010000000000000010000010001001000010100000000010000100000000000000000010100000
01101111101011101110101011111011010111100010111110110101101101110110110101111101110111110100111111001
00000001000000000000101000000000000000000000010000000000000001000100000000010000010000000000001000000
11011110101111111001011110111110111011111011011111011101101110011111100110101011100111011101100011011
00000100000000000001000100010000010000010010000000010001000010000000000000000000000000000000000001000
01011111111101111010110011110101101111011101100111111011101101101001111110101111011110011111101010111
00000000100001000000100000000000100000000100000000000010001000000000000000000100000100000000001000000
00101011011110111011011101101101111011011011101001111110100111111100111111011110101011111000110111010
00000000000000000000000100000000000010000000100000000010100000001000000010001000000000000000000000010
01110111011011101101101101001111011011101111101111011110000101010111111001111111101110111101010111101
00010010000001000000000000000000010000001000001000010000000000000000000000001000001000001000000000000
10111001100110110011100111110110101010110110111110110111101111101101101111010111110010111001100110110
00000000000000000000000000000000000010000000000100010000000010000001000000000000000000000000000000100
01011111101011010111101011001010111011110011110111101001100110101010110100111110111111011010101111110
00000000000001010010001000000000000000000000010000101000000000000000000000000000000001000000000000100
11011100111110110111000100111101101011101100111111101110110111110111110111011111100111101111010101101
00000000001000000001000000000000000000000000000000101000000001000001000010000010000000000100000000000
01111101011101110111100011111111010100110111001111101101111110000111110111011011110110110110010111101
00000101010001000001000000000000000000000001000000100000000000000000100000001000010100100000000000000
11011101100101111001101101001110111101011100110011101010111101011101101101010101100111111111000010111
00001000000000000000000000000000000000000000100000000000000100000000000101010000000000000000000000000
01110101111101011111101101111110110100100111101111111100101011110111011010101101110111011111101010110
00100100000001000000001000010000100000000000000001000000000000100010010000000000010100010000000000000
11110110000011111110011101111010100001111111110101101011110101110111011101111011100011111001111011101
00000000000000001000000000000000000000000100000000001001000000000010010001000000000001000000001010000
11101011111111110010010111101100111001010101011111111011010111111011001111100101101110011111111001101
00000001000000000000000100000100000000000000000000000000010100000000001000000000001000000001000000100
01101110111110101111111001010011111010011111100100011111111000011111011010110101110011110011111110110
01000100001000100000000000000000000000010000000000000010000000000000000000100100000000010000000000000
11101111110100100101111011101110010101101101101111101111000111011001110111001111110101111110111011011
00001000000000000000000000000000010000000000000000000000000100000000000000000010000100000100000001000
11010011111011001010101010111101111010101011111101100101111110110111110101111110101111101010111111110
00000000000000001010100000000000000000001000010001000000000000000100000100100000100000000010000010000
01101011101011111100111010101111010001101111111000001010010111011110111111110101111010101101100101111
00000000000000000000100000000000000000000001000000000000000000000000000000000001000010000000000000000
01010000011111011111111011111001011110110010111111101111011010010011101101111010101011101010110011111
01010000000000000000010000000001001000010000000000001000000000000000000000000000000000001010000000000
10111101111001011111010101111110111111011010000011111011111010101011011100111111111101110011110011101
00001000000000000010000000000100010000000000000000000001000000101010000100000000100001000000000000001
01010001111111111011111001101101111111010011001011011110110111110101111011111000011101101101111110101
01000000000000100001000000100100000000000000000000010000000010000100100000000000000000000100001000000
10000111101011011110011010010110101111111011101111100111111101110110011011110001011011110111011011101
00000000000000000000000000000000000000010000000010000001000000000000000000000000010000100000010000000
10111101110101111001111110111110101111101100101011011011110110011011111100111111110110011011110011101
00001000010100001000000100100000001000000000000000001000010100000000010000000010000000000010000000000
11101001110101001110101101100000111111111011011111111010011111110010100110100101111110101011111011011
00000000010000000000000000000000000000000000001000000000000000000000000000000100100000001001000001000
01101111101101101011101011101110010111011101110111011101011101111101110101111110110111110101111101100
00100000100000000000000000000000000001010000010100010000000100000001000100000000100000100000000000000
11001111110110111111001011110111001101111110011111101101101110110111101110110101111111101110011000110
00000010000010100000001010000100000000001000000010000001000010000001000100000000010000000000000000000
11101111100011001101111110111001011110010001111101011110111011111001111100111001111101001111011101010
00000000000000000100000000000000000000000000010001000100000010000000100000010000000000000000000000000
01010111101011101110010111100111101110111010011010011011011101111110100000011110101111010111011111101
00000000000000000000010100000001000010100000000000000000000000001000000000000000000000000000000010000
11010111111011111000001001111001101010011011111110101111011111010110000111011011110011111101011111100
00000000100010000000000000000000000000000000000000000010010000000100000000000000000000000001001000000
11101101011000010101111111101101110110110111011011111110001110100011011111111100111011101111001101001
00001000000000000000000000000000010010000001001000000000000100000000000000000000100010000000000000000
10111001111011011111001000111101111011111100011110111010111101110010101111011110111111001111001001011
00010000000001000010000000000000000000100000000000100000000001000000000000000100010000000000000000000
01111011011101110101011101011111001100101111001111111110101101110101101101101010111011110101011111101
00100000000100000000000100000000000100000000000000010000101000000000100101001000000000010000000001000
11010110111011101011010011011111011010100111110011101000111110111001110101111111011110100010110111011
00010000000000000000000000001000010000000000000000000000000000000000010000000010000000000000000000000
01010111010110111110111100011110110011111011001110111101110111111100110001011110011001011111010111110
01010000000000000100010000000000000000100001000000000000100010000000000000000000000000000010000000000
01101110110001011011110110111111111111010011110000100010110110111110010101101100111011101100111101101
01000000000000000000000010000000000000000000000000000000100000000000000000100100000000000000000000000
