00000000000000011000010000001000000000001000000000100000000000000000000110000000000000000100000000100
10110110111000111011111011110110001111111111010111101011111011101010010110011110101101011111011100111
00010000001000000000000001000010000000001000010010000001000000000000000000000100000000000001010000000
10111100011111101011100001111111001111110111101010111011101111001101111001110110011101011110101111101
00100000000000001000000000000000000001000000001010001000100010000000000000000000000001000000000100000
01011011001011111101011111101110101001110110111010011011101111111001011101001011011101110111010111110
01010000000000001001000000000000000000100010000000000000000100000000000000000000000100100000010010000
01110111110100011100111111010011101111011010000011011111011111011111011101001010101111110101101110110
00100100000000000000000010000000000001001000000000000000000000000010010000000000000000000000101000000
11011101110111111101010100100111001110111010011011101111010010111110101011111111111011101001001011110
00001000010001000000000000000000000000000000000000100000000000000100000000010000000000000000001000000
01110110010100110110111101100011011111011111110110011101101110110011111111100100100111101100111111011
01000010000000000000000000000000000000000010000000001000000000000000100000000000000000101000000100000
11100101111011100101111101011110100011011100100100111011111111101111111101110111010010110111110111011
00000000000000000001000000001000000000000000000000000000000000100000100000000000000000100100000100000
01100111000011111111011111001011011011111011011011100111011001101111101011111011011111011011110011011
00000000000000000000010000000000010000100010000000000000010000000000000001000000001000000010000000000
11100111111001110110111101011110011011110111011101101101101110111010011011111111011100010011010110110
10000000000001000100000000001000000000100100000000001001000000000000000000100000000000000000000000000
01101011110011110110110110111110011011011100110111101101110000110110111011011111110011110111100111111
00000000010000000000010010100000010000000000010000001000100000000000000000000010000000100000100000000
11101010111010101110110111111000111110001110101011101111101010110011111111111010101011101101111101011
00000000000000000000100100000000000000000100101000000010000000000000001000000000000010001001000000001
01011011110110101101110110111110001101111001101110111001101101110111110001101101101110101010111111010
00000000000010000000000000000000000000000001000000000001001000010000000000000000000010101010001000000
10110001111110101111100110111011111001111111011011110011101101010110011111001001011111101101110110111
00000000000000100000000010100000100000010000010000000000000001010000000000000000000000100000000000001
11101001010111010111111110100110111110001111110111001011100111111011111101100111010111110011011111110
00001000000000000000000100100000000000000001000000000000000001000001000000000010000000000001000100000
01111011110101111001101110111101110111101110011101110111101111001001110111010110111110011001111110010
00001010000000000001001000000001000000001000000101000000001000000000000000010000000000000000100000010
10101101111101110110110111110110101111110010110111101011101111100001111000011110110111010110111011100
00000000001000010100000010000000100000000000000000000000000000000000000000010000000100000000000000000
11011101101111011011101011101101111111011011101111110111101101010100110111110111001010111111010011111
10010000100100010000001010000100000100001010000010000000000000000000100000100010000000000000010000000
10101011110111010000111111101110110011011011111011001101110001111111101101110010110011001011011011011
00000000000100010000000000000000100000000000100001000000000000000000000000000000000000000001001010000
11001111110011110101111101101100111111101110100111111011101100010110111101111010011111011101110111011
00000001000000000100010000100000000000000000000100000000000000000100010000010010000000000101000100001
01011011111001110111111101111000101101111111101111011001111110001111001001111010111101111011110110110
01010000100000000001000000000000101000001000001000000000000000001000000000000000010000100010000000000
11000101111111011011101111011001101001010111011100101101111010111101000111000110111111100111010110110
00000000000000010010000000000000000000000000000000100000000000000000000000000000000010000000000010100
11111100001101111001111110011010001111001110101110111011001111110101111011111101010111101101111101110
00000000000000000000000000000000000100000010100000010010000000010100000000100000010010000100000100100
11010111001011110101110011000011111111111101011101110100101110010000110111111101001101010111110101011
00000010000000000000000000000000000001000001010000000000000000000000000000000000000000000000000000000
01010101111111001110111101010100011111011101001111101101101011101001110111001101111011011010101111110
01000000000000000100000001000000000000000000000000101001000000000000000000000000010001010010000000010
10111111110110011111110001011101011011011111101000011101101110011111110011101011111101100001101111101
00001000000000010000000000010000000000010000000000000000101000000001000000000000100000000000000000000
10111001110100110110011111101101110111011111100001101100111011101100111101101011001111111100111111011
00000000000000000000000010000001000000000000000001000000000001000000000000001000000000100000000100000
01001111111011110111000110111110101011100110111001111110011011111011011110011101100110001111001111001
00000000010000000000000010000000000000100000000000000010000000000000000000000000000000000000001000000
11110101111001111011110110111010111110010111101111011101000100111011001111110111111001110110011011101
00000100000000000001000100001000000000000000100100000001000000000000000000000000000000000000001001000
11110111000110111011101110100101101111010110111010110111101101011111010110110111011100110101011111110
00000000000000010000000000000000000100000010010000000000101000000010000000000000000000010100000010000
11010001101011001111110101101110101011111101000111111110001111101110001101010001111001011110111011101
00000000000000000000010100100010100000000000000000010000000000001000000000000000000000000000000000000
00011111001111101111101101101110111101111010110111101101101110111011110011111100110110110111110110000
00000000000000100010000101001000010000010010010000000000000100001001000000000000000000000000000000000
11100111111001001101110011111010110111110101011110001111110111100011101011010100001111111111101010110
00000001000000000000000000000010000000000000001000000000000000000000001000000000000000000000000000000
01111101111110110110100101101010100111110111010001011011011111111111000111101101111101101111001011111
01000001000000000000000101000000000000000000010000000000000000100000000010000000100000000100000000001
11101111111001100111111010110111001100101111111101111010011111111011011001111101101110011110111100111
00000100000000000001000000010000000000000000010000010010000000100000010000000100000000000010000000000
01011110101110101011011111011110111111101001111111110010010010101101111101111101110011000111111101110
01001000000000100000000010001000001000000000000000000000000000101000001000001000000000000000010000000
11010001101111011111101111101010101111000111110000111110110110110011011100111101101101101101011110101
00000000000000000100000000000000000000000100000000000100000010100000000000000001001001000100000000000
01101111011100101111110011001011111100011111011110110011000111110110111101011101001111011101010111111
01000100001000000000100000000000000000000000010000000000000000010000000100000000000000000001000000001
10111001110111001111100101111011100111111110101101111100010011011100011011111010111001011111111111001
00000000000001000000000000000010000001000000001001000000000000000000000000001010100000000001000000001
01101111101100111110010011011110001011111011110100101110111111001111110100011111011011000010111001111
00100000000000000000000000010000000000001000100000000000000000000000000000000000000000000010100000000
00101111110110111101101101010111111101110111011110111110011111100111100110001111000011001111101101011
00000000000100000000000000010000100000000100000000100000000000000000000000000000000001000000000000000
11011110101101101011101110110110111110011110110100111110111101110111011111100110101011011111011011110
00001000000000101000101000100000000000001000010000000000010000010010001000000000000000000100001000000
10111111001001110111000111011111101000111101110011111110101101111110011010111110011010110111011011011
00100000000000100100000000000010001000000000000000001000000000100000001000000000000000010000000000000
01100011101101111101111101101101010111110111110101110011110110011111010011011101110110101110101111101
00000000000000000100100001001001000000010010000000100000000000000000000001000000010100000010000000000
10101110110101101101101100111011101101111111011100011101011111110111101110101110110011101111001111101
00000010100101000000100000000000000000010000000000000100000001000000001000100000000000100010000000100
11101010011100110111110111111100101110110101011110101111101111010111011110111000101111011101111100111
00000000000100000000000010000000101000010101000100000010000000000100001000000000000000010000100000000
01101011101101111010111001101111011011101111111011100000011110111100110011101111100011011111010111100
01000000100000001010000000000000001000000100000000000000000000000000000000000000000000010000000000000
01100111111111010100111000110111101011110101111110010111111110100001101111101101110111011010100101111
00100000000000000000000000000100001000100000000000000100000000000000000010001000100100000000000000000
11001111110011110011111111001011111101000111111011110111100110011110001101111111011101011101010110111
00000000100000000000100000001010000000000000100000100000000000000000000000001000010000000001000000000
01110100111011110111011011111101011111110010011101111001011010011000111110110111100111110111010111011
00010000000000010000000000100000010000000000000000000000000000000000000010100001000000100001010001000
11011100101001101110111011110011010011111111011011101010111110111101101100001100011111011111111100111
10010000000000000000000000000001010000000010000001000000000000100000100100000000000000000000000000000
