00000000000010000100000000000000000000010000000010000000000000000000000000000000000000100000000000000
11101100111101101101101011100011100011011110101110110101101111101101011011011101101101011000111111001
00001000000000000000000000000000000000000010100000010000000000101001010000000000000000000000001000000
01111011011111110101100101111100111111010111110011111011011011011101111111110000111011110101110110101
00000010001000000000000100010000000100000000100000000010010000001000010000000000010010000000010100100
01111100011011111011110111110011110001111111111011000011011011111011111001010110111110101011111101011
00000000000000010000100000100000000000000010000000000000000000100001000000000000000000100000001000000
01100111110011010111101110111110010101001111100111101100111001011111111010101101111011111101011111011
00000000000000000000000100000000000000000000000001000100000000000000010000000000001000001001000000001
10111111010011101110001010111110100111101101110110010111110110010110111001111101011111100010111110110
00000000000010000000000000000000100000000000100000000000000100000000000000001000000010000000000000010
10101111101110101011010111011011010111111100101010111011101110010111101110110101111101100011101011101
00000000101000000000000000000010010001000000100000000000101000000000001000100100000000000000000000100
11011101100111110111100111100111011110111111001010110010011110011111101101101101101010111001111110111
00000000100000000001000000000000001000000000000010000000000000000000000000000101000000000000000100000
10101011110101111110110011111011101101101101011110011111101100111111011111101001100111010111101101101
00100000000000010000000000100000101000000000001000000001001000000000010000000000000001010000000000000
10101111111101111100110111111110011011100111011011001111011100111101111011011101101000110111110011111
00100001000001000000010001000000001000100000000000000000000000001000100010000000100000000000000000000
11010111010111011111100101010101101101110011111011101110111110010101111011011101111101011010110111110
00000010000000000000000001010100000000010000001000000100000000010000000000000001000001000000000000010
10110111011101111100110100110011101011011101101100111011111101000111101101010100111110111011110101011
00100000000001000000000000000000000000000000000000010010000000000000000001000000000000000000000001000
11110110101110011010111111100111011111001111101000111110001110001111001111011110111011111001111010111
00000000000000010010000010000000000000001000000000000000000010000000000000000010010000000000100000000
11110101100011111111110100011011101110100100100100111101111111111001101101101011111011001001011110110
00000000000000010000000000001000000000000000000000000000000001000000000001001010000000000000000000100
01101110111111101010101001101001101110011001101101110111110010111111000100111101101011111101001110111
01000000000000000000000000000000000000000000101000000100000010000000000000000101000000010000000000000
10111111011100110110001011001110111101100011111101111011010110011010110111010100111111101111011111010
00000000000000000000000000000010010000000000000101000000000000001010000000000000000001000000001000000
11110101110011010111101011111011010111111110100101111000100111011110110100010010111101111101101111001
00000000000001000000000001000000010001000000000001000000000000000010000000000000000000000000000000000
10111101101111010111111001011111011100110101101110110110101111001111011011100111101110110011110011111
00000001000100000000100000000010000000000000000100000000000010000000000010000000000100000000010000000
01111011111001110001111101110111101110101101101111110101110110111010111001111111010111000001111101101
00000000000000000001000001000000001000100000000010000001000000001000000000000000000000000000000001001
01111110101110110111110101101010000111010011111101010110110111011110101100110111110101111101111111001
00000000100100000000000000000000000000000000000000000000010010000100000000000000000100000000100000000
10110110101110100111101101101010011101111010101011111011011101101101110111001101101100111010111110110
00000010000000000000000000000000000000000010000000000010001000000000000010000000000000000000000000000
11101110101100100111111110011110111101110010111111011110010101111110111001101111100100011111111111011
00001000000000000000000100000000001000000000000010000010000000000000000000100000100000000000000100000
01101100111011011101011110011011101010110011111111011011011111011101110011111010111110111010011011111
00000000000000001001000000000000100000000000000000010000001000000001000000001000000010001010000000000
01111111000101011111001111101111111010111110100111111011011101100110011111101001111111011110001011101
00000000000100000010000001000001000000100000100000010000000000000000000100000000001000000000000000100
10111010011101110101101011101001111110011011101011001010110111111111101100010111001011011011101011110
00000000000000000001000000100000000000000000000000000000000000100000000000000000000001001010001000100
00100011010011111111010111110111011101110010111011011011011111110110101111100111011111011100111000111
00000000000000000000000000000010000000000010000001000000000010000000000100000001000000000000000000001
11011101011011111001011100111101110110000111011111111111101101111100001101101111001111010111110101111
00000001000000010000000000000000000010000000000000001000001000000000000000000000000000010100000100000
11011011111110000111110100110111100111101100011011111011011111101111001101110110010011111010111011011
00010000000000000000000000010001000000000000000000000001000100000100000000000100000000000000000001000
10101010100100110001011111110000111101111111110111111000110110111101101101100011001011111101011110110
00100000000000000000000000000000000000000000010010000000000010001000000100000000000000000000000010100
01101011101111010000011111010110101111101110111110111101100111111011101101101111111010110110111100111
01000000100000010000000000000000000000000000001000010000100000000001001000100010000010010000000000000
11011110111101011010111011101111110101100111101111101010101101011111001111110011000110011111010110110
00000000100000000000010001000010000001000000101000000000000001000010000000000000000000000000000000000
11011011110101111101110111011110110010101010111110101111110111110110011110111101011111010101101111001
00010000100000010000100000000000000000000010000010000001000010000000001000010000000010000000000000000
01110111100011101111010111001110011111011111101101101110000111101111111001111111011111100111011101110
00010100000000000000000100000000000100001000001000100000000000000001000000010000010000000010001000010
01101110010111101111100110111011110111110111011100001011011011001011110101111101101001101101111111100
01000000000001000000000000100000000100000000000000000000001001000000000000001000100000000000000000000
11011100101101100111110011110101001110111101100010111110111011000111101011101101101101110110011111010
00010000000000000000100000000000000000000000000000001000000000000000100000000000000000000100000000000
11011011011101011110111101111011010101110111101110110010111110011111011100001101111011100101101110110
00000001000101000000100001000000000000000100001000000000000000010000000000000000100000000000000000010
01110101111011011111011001111011101110100101101111111011010111110011101101101111100110111011111001001
00000000000010000000010000000000000000000001000010000000000100000000001001000100000000000000000000001
11001101111111000110010111111001011011111111011100110111101100111010101110011100110111110111101111101
00000000000000000000000010000001000000010000000000100000001000000000000000000000000001000001000010001
01011011111011111010111100111111011101011111101101110011011110111011101110111111101101110111010011101
00000000000010000010100000000100000000001000001000000000000100010000100000000100000101000100000000000
10111110111011110001111110110011100011110011111010011001011111101101111100111101111101101111101011101
00001000000000000000100000000000000000000010000000001000000000100100010000000100000100000010000001000
01110011111110111001111101111111011011011110011110011010111101101111110111011011101011110111011011101
00100000000100000000001000001000001001000000000000000010000000100000100100010001000000010100001000100
00111111010111101111011101111110010111011110111111100101111110111000011110111011110011110110101110001
00000000000010000010000000010000000001010000010000000100100000000000000010000000000000000000000000000
01101101010111101111101101101110111001101110101111110111001100000111101111111011011011100111111011110
00000000000000000010000100000000000000000100000001000000000100000000000000000001000000000001000010000
11001111011011101111100111011111100110111011110111101011010001111111111110101100111011111011100101011
00000001001000000000000010000010000000001000010000000001000000000001000000000000010000000000000001000
11100111000111111101011001110101011101110101001101110111111010011111010011111101111011010110101101110
00000001000000000000000000000101000000000000000000010000100000000001000000000100010010000000000000000
11111101001011111011101000011101101000000111011111101111111011110111110101100111111110010111110111101
00000000000010000000000000000000001000000000000000000000010000000010000001000000000000010010000010000
11101011001111010100111010110111101111011001100111111111010110110111011010111110101111101101111111001
00000000000000000000010000000000001000010000000000010000000100000000000000010000100001000000001000000
11011110110111111010010101101111110001101101011111011010100101110011101101101110110100111011111011011
00000000100000000000000000000100000000000000000000000000000100100000000000000010100000000000010000000
11011111011110011101101111010111111001111011011011111000101110111110111101100011111100111010000001111
10000000010000001000000100000000000001000010000000000000000100000000000000000000000000000000000000001
01111101001110111011110101011001101101001111111101110101111111011010001111110011100110101011011001111
00000001000000000000000000000000000101000000001000000100000000000000000100000000000010101010000000000
11010111001011000101010101111101011111101111110111001011101111110010111111011110010101110000111000111
10000000000000000000000000000000000000100000000000001010000000000000100000000000000000000000000000000
