00000000001000010001000000000000000011000000000000000000000000000000100001000000000010000001000000000
10110101001110110101111010111001111110100110101011011100011100011111111010111010111110111110010111011
00000000000000000000001010100000000000000010000000000000000000000000000000001000000000100000010010001
11110111110000011011111100100111111001110111011011001101011011111011110111011011110101101111011110101
00000000000000001000010000000000000000000000010010000000000000000001000000001001000100000000001000100
11011110010101111011101001011110010111110101011111011000110101011111101111101101011000110011111110111
00000000000000100000000000000000000000000001000100000000000000000000100000100000000000000000000010000
11011100111111010101001101101110101001101110111011111101111001011010111010101011011101111111001011101
00000000010000000000000000101000000000000000000001000000000000000000000000000010000000010000000000000
00001111011101100001111101111101111111010101111111001111011101110101011110011111011111010101111110101
00000000000000000000000000000100000100000000010000000010000000000000010000000010010000010000001000000
01111110101110101110111111010111011000011110101111110011101110011001111011011110101101010101111111011
00000000001000100010100000000000000000000000100010000000100100000000000000000100101001000000000100000
10111101100111110110111101111101110111110011011010111011110011110011110001010101111111111010110101110
00000000000100000000100001000001000000000010000000000000000001000000010000000000000000010000000000010
01111011011010110101111011110111101011001110110101111101101011101110011011011011011010111110110010101
01000010000000000000010000010000000000000000000100000000000001000000000001001000000000000000000000000
11111111111111110100000101001110111000101100011111011111011110011110101110011101001101111010101101110
00000000000000000000000000000000000000000000010000010000010000000000000000000000000100000000000000010
11001100111111011011011101110111011110011001111011101111010110101101011101101011111111011001111111100
00000000000100000010001000000010001000000000001010000000010010000000000000000000010000000000100000000
11110111100011001111111010001111110111110101011010111101001111010110100111011111011100110101101110011
00000000000010000000100000000000100000100000000000000000000010010100000000000000000000000001000000000
01101111011011010111000111010111111100101111011101100111101101111101110000111111110110111001111011101
00000000000000010000000000000000100000000000001000000000001000010000010000000000000010010000000001000
10010111011011101011111111000101100110011110011101101101110011101111011011111101101000111110111011101
00000000000000000000100000000000000000000000000000001001000000100010010000000000000000010000000010000
01101101110110101110010110111111011001111001011100011101110111111011110111111001101111100110111010101
00000000000010100100000000000000000000000000001000000000000000100000100010000001000100000000000000000
11101101111011111011111010011111001010111000010101101010111111111000111110100110011111101011011111110
00001000100000100010000000000000001000000000000000000000000000000000000000000000000010000001000100000
11101011111000110101111000110101111101100111101010101111111011111001111100100110100101111001101110111
00000000000000010101000000000000000000000000000010000000100000000000000000000000000000010000000000000
10111101101111011110101101111111011101010111111110110011101100110110001111100110001110110110011111011
00100000001000001000000000010000000000000100000000000000000000000000001000000000000000000000000100000
11011011101111011100101111101110101000011111110011111111101101110111101011111101100111011011110111010
00001010000010001000000000100000000000000000000000001000001001000000001000000000000010000001000000000
01111011011100101011101111101000111101101111101111010111011101100001011101011100011011111101111010110
01000001000100000000000000000000000000100000100000010010000000000000000000000000000000000000010010010
01110001101011111101001111100111111101011101100111110110100111110011011100110101111110111011111011101
01000000000000000000000000000010000000010000000001000010100000000000000000000000001000001000100000000
11101101011101011110011101001101111101011111010111011101011001101010010111101111111010111110111010110
00001000000101000000000000000000001000000000000010000101010000000000000000000000010000001000000000100
11011101000110111111001111110101110010001110111110011001101110111010110111111010010101011110111011110
00000001000000000000000000000000000000000000100000010000000000000000010000000000000000000010010000100
01011111110011110110011100111010011111101111110111001001110011101101101110110101110110001011110111101
00000001000000010100000000000000000000101000000000000000000010000000000000000000000000000001000010000
10110110111010110111110111110111001111100111111011100111101010101100111100111111011110101011000111111
00010000000000000010000010000100000001000000010000000000000000000000000100000010000000000010000000000
11101101111111001101111010011111101111001111111010110010001111100111110110100011111011101011111111001
10000000010000001000001010000001000000000000000000000000001000000010000000000000000010000000010000000
10111011110110111101010110000101001110001100111111111101111111001011010111111011100111111100111010011
00100000000000000000000000000100000000000000000000000101000000001000000000010000000001000000000000000
01101111101101111110000111101011011001111110111011011101100011011110011111110110010011011101111110010
00000001000000000000000000001001010000000100001000000000000000000000000010000000000000000000000000000
01101111111000101100010111110110011010010111111011111001111100111011010111111011011100110111110101110
01000000000000000000000000000100000000000000000000100000000000000000010000100000000000100100000001000
01011011101111011111110110110100100101110111110011111011111000100101010100101001111111110010101101101
01000000100100001000000000000000000000000100000000000000000000000000000000000000000000000000001000100
01111110111111000100010111010100111111010101011111010011011001111111001111111010110101111111010110111
00001000000000000000000000000000000000000000001000000000000000001000000001000000100000000100010010000
11111010111101101111101011110001110001111111100001111000101110111111110101011110110110011101010110111
00000000100000101000001000100000000000000000000000000000000000000000000000010000010000000000000000000
10111101110011001010110111110111110110100110100011111011110111001110111011111010110110000111111110110
00000000000000000000000001000100000000000100100000000000000000001000001000000000010000000000000000010
01011110001011111101101110111001011111010001010111110111110001000111111011011101110101010111001111101
01000000000000001001000100000000000000000000000000000000000001000000000000000000100000000000000000000
11101100011101110111101101011011100111111111101101111101011101111110011111011111100110001001011111100
00001000000000000000000000010001000000001000001000100001000000010000001000000000000000000000000000000
10010111111100101111011101011111011100111001000101111100101111011011011111101000111011011101111111110
00000000000000100000000000010000000000000000000000000000000010000001001000001000000000000000000100000
10110110111111000111111110011111010101011111101001101101101101001111101101001100111001111111001010111
00000010010000000000100000001000000101000000000000001000100000000000000000000000000000000000000000001
10111111110101111011010111110111010011000111111010111100100101101001111001111011110111111000011111110
00000100000100000001000000000000000000000000000010000000000000000000000000000000100001000000000000000
10101111011101101111000010110111111101110101101011110111100011011110111001011011101011011111101111101
00000000000000000000000010010000100000000000001010000000000000001000100000000000101000000010000010001
11011010101111011010011111110011100010111110110110101111111100001111011110111001011101011011010011111
00010010000001010000000001000000000000000010010000000001000000000001000000000000000000010000000000000
01001101011111011111111110011101111111110001111010111011011100101011011101010101011101011101001101011
00000000000000000010000000010000010000000001000000000000000000000000000000000000000000000000001001000
11001110110111001111001101111011101011010111110111010110101101110101101110111101111010011101110110111
00000000000000000100000000000001000000000000100100010100000000000100101000000001000000000000010000000
11100101101101011101111011101011110111011111000000111110111101010110111111011010101100101111011011101
00000000000000000100000000001000000010010000000000000000000000000000010000000000000000100001000000100
10101110111101010111110111101011110111011111011011111110101110110110011111011101100001101111110111101
00000010010001010000000010000000100001000100001000010000101000000000001000000001000000000000000000001
11110111111101110011000001111100111100111111010011110011110111101110111111100111010100110101011111101
00000100000000000000000000010000000000000000000010000001000001001000001000000000000000010101000000001
11110110010010110010111110101101011001011111111011000010101111111101110110111101011011011111011100101
00000000000000000000000000000101010000000000100000000000000000000100100010100000000001010000000000000
11110011011111101110011111001111001010010001111010111111010110111111011110000111101101110011101100111
00000001000100000000000000000000000000000000001000000001000000000000000000000010000000000001000000000
01111011010111010100011110111000101101101000111011111110011111111001011100110111010001011111001111011
00010001000000000000000000000000000000000000000000000000000001000000000100000000000000000000000000000
01111011011011101100111101110101011111110001101111011101110100111011001001111100110010111110011011011
00100000010000000000000100000000000000000001000010000000000000000000000000010000000000000000000000000
01111101110101110110111101010111000111101111101100001111101110101011111100101111100011110111110011010
00000000100100100000000000000000000000101000000000000000100010000000000000000100000000010100000000000
11011110101010111010011111001111011101111001110111011101101011111011011100011111100111100100011011111
00001000000000001010000000000000000001000000010000001001001001000010000000000000000000000100000000000
