00000000000000000000100000000001000000000010000000000000000000010000100000000000100000000000000001010
01011010110110111010111110111011110111101101111011000111011011101011101111011001011111011111011011101
01000000000000000010000010100001000001000000000000000001001010001010000000000001000001000001000000000
11011101101111101010100110001001111101111111111010111101111111111100010001111011011001111111111010000
00010001000100001000000000000000000000000000010010010000010000000000000000000000000000100000000000000
11101011011101011110011110101110110011111100011110101101110010111110111100110011111011011100111000101
00000000001001001000000100000000000000100000000000000000000010000000000000000010000000000000000000000
00111110111101011111110100001110110010001111111101111101111010111011110001010101111111110100111011101
00000010001001010000000000000000000000000000010000100001000000001000000000000000000010000000000010000
11110101011010101111011001011001111011111011111000100011100101110110111001101011111100011111011011110
00000001001010100100000000000000000000000000000000000000000100010000001000000000000000000000010000100
11011100011110101011011111101100011101101010111111110110001111011011111001101101110110110011111111010
00000000000100000000000000000000010000000000001000000000000010001000000000100100010100010000001000000
01101101011111100111111101111111001101011101111111011000111011110110111110010011001110110101101111010
00100000000001000000010000010000000001000100000000000000100000000000000000000000001000000000001000000
11010101111011110000111100111101011111001000111111011000110111100110110111110101110101010101111010110
00010000000000000000000000000100000010000000000000000000000000000000000001000000000000000000001010010
11111011101111011110101011110011110111110100111111110001001010111101111101110001011111101111001110111
10000010000000010000100000000000010010000000000000000000000000010001000000000001000000001000000010000
10100110111110111110111110101110010111001111001111011111101110110100010101110111111110100100011111010
00000000000000100000100000001000000000000000000010001000000000000000000000010001000000000000000000010
01100111111010111110100111010110110011100011111011101111111001011011111101101011111111010100110110111
00000000010000000000000000000000000001000000000001000010000000001000100000000010000000000000100100000
00011111111110111100110001111010111101110011111110101011001101111111011011110101001111011101110101011
00000000010000000000100000000000000000010000000010100000000000000010010000000100000000000000000000000
01111101111011011100111101110110101110111011101011000101011011111110111011111011110111110001011011110
00010001000000001000000000010000000000001000100000000000000000000010000001000001000000000001000000010
11101011011010011111011111010101101111010110110111111011100110101111101111101011101010100111011111100
00000010010000000000001000000000100010010000000001000010000000000010000000000000000000000100010000000
11011101011100111001111111100011111000110100001011111110111001010111111100111110110111110111101101111
00000101000000000000001000000000010000000000000000000000000000000000000100000010000000100100000100000
01011111111011101010111011110111110110010010011101111110110011111110110010001111111111111110011000100
00000000100000000010001000100010000100000000000000000000000000010000100000000000000000000000000000000
11101110011101011111010111110101101110111101111110011011001101101111010110101110110011101011111111110
00000000000001000100000000000001000010000000100000000000000100000000000000000100010000000000000100000
11111011111001001011101100011110111100110111010111110111101111100101011110111100111101101110111011011
00000000000000000000000000001000000000100010000000010000001000000100000010000000000001000000010000001
10111111010101011101111011111011011111010111101001011110011101111101011111000110111001011111010111011
00010000010000000000010000000010000000010100000000000000001000010000001000000000000000000001000000000
01111000111101110101111110001101011001111011101110110011111100110101111101110111111001101011111101110
01000000000001000000000000001001001000000000100100100000000100000000000100000001000000000001000001000
01101110011110110111011101011011101001111011110011011111011110011111110011011011010111101101100111111
01000000000010000000000000000001000000000000000001000010001000000100000000001000000000100000000000001
01101101011011111011110000101111000011111100111111001101101111100101011110101101111101011011110101110
00100100000000000000000000000010000000000000000000001000000000000000000100000000000000000010000101000
10111001101110101101111110111010110110110111011111001110110111101001111111010111101111011101110111010
00100000000000000100000100100000000000100001000000000100000000100000000001000000000000010000100000010
11011101011100110100111111111101101111001111101110101111011100101111111011100011100111010110001111000
00010000000000010100000001000000001000000010001000000100000000000000000000000000000000000000000000000
11110101100110111110111101011011011100111011101111101110111001111111111001011110101001011101001111010
00000100000000000100000001000000000000001000000100000100001000000010000000000000000000000000000000000
01111110011100110111101111011111101110010001110101111111011111010111111011110111110011110111011011101
00001000000000000000000100000100000000010000000000000010000010000001000010000010000000000100010000100
11111010101111011110110101001111101101111110110111011111110111100001111111001010011001111101110101101
10000000001000010000010100000000000100000100000010000000000000000001000000000000001000000100000000000
01111110011110101010101001110010011101111001110100101101111111110011100011011100011110101110111100101
01000000000000000000000000000000000000000000010000000000000000000000000001001000000000000000000000000
01111110101010110110111101111111100010110101111111011111011101101111111100101001101111110101111111010
01000000000010100010000000100000000000010000000010000010010000100100000000001000000000010000000100010
10111100111110101100101111001111101011100111110110011000111110111111011110101100110101111001111011011
00000000000000000000000100000000101000000000000000001000000000000100000000000000000001000000000010001
01011111101110111101011111100001111101111010011011100111101001111110111011101101101111011010111111011
01000001000100000001010000000000001000000000000000000001001000000010000000000000001000000010000010000
01110011110110111111110101111011010101100111111011110111000001111111011011101110111001111101010111011
01000000010000000010000101000000000000100000000001000100000000000000001000000010001000000000000000000
10111001110101110101101111110001110101110111101000011110110111011101111101010101111011111010010111110
00000000000100100000000000000000100100100000000000000000000000010001000001000000000000010000000000010
01110111010100100111011111111001111101101111111101011110010111001110111111011101100010111011011111100
00000010000000000000000000100000000101000001000001000000000000000010000000000000000000010000000000000
01111101101101001101110011111110011110111010011111101110111101111010001101101011101101111101011111100
00010000001001000000000000000100000010100000000010000000100000000000000101000000100000000100000000000
01110101101011111101101011100100101101111101011001110101101101101001101101010111010110110110111011101
00000000000000010000000000000000000000000000000000000000000000000000000000000000000000100100100010000
00111111101101011111101110001010111011011011111011011001110111101011011110111110010111001101101101110
00000001000101010000000000000010100000000001000000000000100100000001001000100000010000000000000000100
01010011010111111101010111111010111101011111001111011100111111001101110011111010111000111100111011100
00000000000000001000000000000000100000000000001000010000001000000100000000000000000000000000000000000
11110011011001101110110111111010101110010111001111001011101100111100111111010011110110101011101101011
00000000000000100000010000000000000000000000000000000001000000000000000000000010000100100000000000000
10101100111110111001010101011101110101101111111101010111000100111111111010111101110111011011101110110
10101000000000000000000000000000010000000001000000010000000000000000010000000000100000001010000000000
01010011110111110110101111100111100101011101001111110110011110011110101110110101100111101010111110011
01000000000000000000101000000100000000000100000000010100000000000000100000000000000001001010000000001
10111010101001100111111010101111111100001111111101011111110001110111001110101111000011011101101111010
00000000000000000000000010000000100000000000001000000000000000000100000000000000000000000000100000010
10111101011111011101110100011111010111001001001101111011111011111011011011000100111100111101101111101
00001001000000000000000000010000000100000000000000000000010010000000000000000100000000000000100001000
10110111111101001101010111110110101111101100110110101011100101010111111111111001101111110011111110001
10000000000000001001010001000010101000000000000000000010000000000000001000000001000100000001000000000
10101101111110101110000111111010110111101011111011011111001011101011111111010111110010111010101110111
00101000010000001000000000000000010000000001000000010000001000100000010000000010000000000010100000000
10000111110101010101111011100100111001111111001011001111101101101111110101110100011001011111111011101
00000000000000000000000000100000000000000000000000000000101000000010000001000000000000000000010001000
01110111011011101110001011101111101101101110111100110111111011101001000110111100011111010111101110101
01000010000000000100000000000000000100100010000000000001000010000000000000000000000000000000000000001
11011101011011011010111011010101111101111011011010110111110110001111111101110011100011110010011111101
00000101000000000000000010000000001000000001000000000000100010000000000000000000000001000000000001001
01111111101111111000010011001110011010111011110110111101101011111110011001110111111011001101101111101
00000100000000000000010000000000000000000000000000001001000000000000000001000010000000000101000001000
01110111101111100100110111111011101011011110110101011001110010111001111111101011011101111101101111101
00100100000100000000000000100000000000010000010000000000000000000000000000001001000000100000100000100
