00000000000000100000010001000000011000000000000000001000010000011000100100000000100100010010000000000
01111011101010001111011111110100100101000101011101111000100000110111111110110011111001111111110100110
01000000000000000000000000000000000000000000000000001000000000000000000000000000000000000100000000000
01111010100011111011111010111110011110011101110111000111011111101011001101010110111101111001111110100
00001000000000000000001000000000001000000000000010000000000010000000000000000000000001000000000000000
11011001111001111110111010110101111101111110110111101101111011111001111101011011110010101011111101111
00000000010000000010000000000000010000010000010000100000010000000000100000001000000000000000000100000
11110101101110111110111110000001110010001110110111001111101101011011100011111011011110110011010100111
00000000000000000000000000000000000000000100000001000000000100000000000000001000000000000000000000000
11101011100111011101111101101111011101111110001011111101011111011011011110101110111101101111001111101
00001000000000000001000001000010001000010000000000000000001000010000000100101000100001000010000000000
10111111101011101011101110111110111001011101010011010110111111100011011111010101011111011011111010101
00000100000000001010000010100000000000000000000001000000000000000001010000000000001000001010000010100
11100110101111111100110111010111101011011110111011110110110111011011011010111110101011110111101111011
00000000000001000000010000000000000000010000010000000000100100000000000010000000101000100001000100000
10110111110010111101111101011001011110111111001011110111101101110111111011011000100011110110100111111
00000000000010000100000100000000000000000000000001000010000000000100000000000000000000010000000000000
11011010111101111010101011110111110101011110110101101110001011110100110101111111010100110101111011110
00000010000101000000000000100100000001000000000000000000000000000000000000000000000000100100001000000
11110110010110011111111010101101010111111101000011110001111010110011111111111010000011110111101011011
00000000000000000100000000000000000000000000000000000000100000000000001000000000000000010010000000000
11101111001011011110011001011111101101111011101011000101111101111101010101101111100011110101101110111
00000000001001000000000000000000100100000000100000000000000000000000010101000010000000000000000100000
10111011111101101111101110001011111010111111010101110111101101011100010111001111001011111001111110110
00010000100000001000000000000000100000000100000000000100000000001000000000000000000000000000000100010
11101101010001111111100111101110101111101100100001011110101011111011100111100110111001111011011011011
00000001000000000000000010000100100000000000000000000000000000000000000010000000000000001000000000000
01111001111010111100111110010011111011111101011111011001001101000110011111100010011100111111101110101
01000000000000100000010000000000010000000000000000000000000000000000000000000000000000001000001000100
01111110101111001011111101111101011010000101111010011101101001110111110100110101111111010110101111101
00010000000000001001000000000000000000000000000010000000000000000000010100000000000000000100100010001
01110101101101111110010011101111110111011111010011100001101111111101111011101111101110110111011011110
00010100100100100000000000100000100100001000010000000000000000000100000000100000000100000000001000010
11011001111110101111101101111000111101011111001001001111111111101110110111010011111110111010110110111
00010000001000000001000000010000000000000001000000000000000000100010100000000000010000000000100000001
11111110010101110111011110101110101011110101111101001111010101111010111011011101011101100001110111111
00000000000001000001001000000000000000000100010001000000000000000000000001000101000000000000000000001
11111001011101110111101001111111111011100101101011110110111101011111001101111101101011000100111111010
00000000010000010000100000000001000000000000000001000100010000000000000000000000000000000000100000000
11100011011111010111101111011011011001011110101111001111101111111000101110110111110011101110101111100
00000000000100000000101000000000000001000100000010000000001000000000000100000010000000000100000000000
01101011000100001111111101111110101111110110110101011110111010110110111010111001101111100010111101101
00100000000000000000000000000100000001000010100000000000010010010100000000000000000000000010000000100
11101111110111001101111011001111001111101001101100101111011011001000111111110110100001111111100110111
00000100000100000000001001000000000000000000000000000000010010000000000000000010100000000000000000000
10001111111101111011110101011110110011100111011011101110111101101111010001101111010111001110101110110
00000000001000001010000001010000100000000000000000000100000000000000000000000100010100000000000010010
11111010110011111111010110011101101101011110111010111111100101111110001111100111101111011011101011011
00000000000001000000000000010000000101010000100000010000000100000000000001000000000000010001001000000
10111111011011111001010011001111111001110110011110110101001111110010111010111101101101111111000101100
00001000000000000000000000000100000001000000000010100000000000000000000000000001000000000000000000000
00101010110011111011101111101111011101010011110110110111101110011101011100111111111011110111101100111
00000000000000000000000000001000001000000000000000000010000000000101000100000001000010000010000000000
10111101101110110110101111101011110111110001111101011111011111010111010101110111110011110101011110101
00001000000000000100000000001010000100000000000001000001001000000100000000000001000000100000000000000
11101111011011110110110011111011101111101101101111011100011110111110111010010111101111011110100110111
00000100000001000000100000010000001000001000101000000000001000100000100000000000000000010000000000001
11100111111001110111100101111011110010111010111011100000101111111011111110000111011011011110111011011
00000001000000000000000000100000000010010000001010000000000000000000100000000000000000001000010000000
01111010110111011100100111011101111011010111101001001111110111001011101110110101110110101110111101100
00100000000010000000000000000000000010000000000000000000010001000000000000000000000010100000000000000
11101101110101011100111111101011011001111111010111011110111101110001110111000111110101110011111101101
00000000100101000000000100000000010000000100010000000100000000000000100000000000000100000000001000101
11011011101101011101101011101101111010011100111111100110101111111010110011101011111110111110011111110
00000000000000010000000000000100100000000000000100000000000001000000100000000000010000010000000100000
10100110111111101001010111101001011100101111110110111011100001011101110011111100110111101110001111111
10100000000000000001010000000000000000000000010100010010000000000000000000001000000000000010000000000
11011011100010111110001100111111011111101000111101101101100011101110111111101100011101111111011111010
00000000000000000000000000000010010000000000010000101000000000000000001000000000001000010000010000000
01111010111011101110001111101110111110101011101111101011111100100111111011101100110010101110111011110
01000010001001000000000000100100000000000010000010001010000000000000100000001000000000000000000000000
01111111100101101111100101100011101111111101101101110111101101101111011101111001101111011101111011011
00000100000000000000000001000000000001000000001001000001000000101000001000001000000000001000001010000
01010011110011101110111110111101101101110010111110110110110110110101111101101111011001111100011001111
00000000000000000000000100100000000000000000010000100000010000000000000000001000010000000000000000000
10011111110101011100001111111011101111101111100111111010101101110101111011000011111111011011011011101
10000000000000010000000000000001000001000001000000010010100000010101000001000000000000001000000000000
00111111111011011111010110111011111100111000111111100111110110001111010111010100010111111001101001111
00000010000010010000000100000010000000000000001000000000000000001000000000000000000000100000000000000
10100111100110111110111100110110111101101111110110101101110101011011101110111110101011111010111000110
00000000000000000100000000000010100000100010000000001000000100000000000010000000001000000000000000010
11110001111110001111110111110110001110011111011000011010011101111111010111101110110111011101100111101
00000000010000000000100000000000000000001000000000000000000000000010000000001000000000010000000000000
10111011100110110101111010011110111101101111101101110111110011101111011011011110101111101000111100111
00010001000000000000000000000100010000001000001000000001000000100010001000000010000000000000000000000
11101011011011011101101101101011111111010101110111011111011101110111011010111111110110111110011110111
00000001000000000000001000100000010000010100000001000010000001000001010010000010000010000010000000000
10101101110101110010111101011111010010111011101001110101110100111010110101111011010101111101010111011
00000000000000010000000000000000000000000000000000010100000000000000000000000000010100000000000010000
10110111101010111011111001101110111111011101001100101111101111011001110101100110011011111111011011101
00000000100000000000000000100010000100000000000000000001000000000000000101000000000000000100000000100
11011011101110110110111001010111001111011011101111010111011111011110111101111010100110011111110010001
00000000100000010000000000000000000000000000001000000001001000010000100000000000000000000000000000000
11011111010111110101110101011011111100111001111111110011111110011101010110011111101101000111111011100
10000010010000000100010000000000000000100000000100000010000000010001010000000000000000000001000000000
11110001010111101101101110110011111111010101101010101100110111110110111011001111110001111010110111011
00000000000000001000000000000000100000000000001000000000000000000000001010000000100000000000000000001
01011110111011000011111111011000101111110110010110100011111101001111111011110111011110111110001100110
00000000000000000000000000000000100000000000000000000000001001000000001000010000000000000000000000010
01101011111111010101111101111111110101101000001111101111101111000111001111101010111011011110110111011
00000000001000000100000101000000000000000000000010001000000000000000001000001010000000001000010100000
