00000000000000000001000000010000000000000010000001001000000000000100100000000000000000000001000000000
01001110101011111001111011101101101111010110111110011001110111110110100111111010110101110111110110110
00000000000000000000001010000001001000000100000000000000000100000000000010000000000100000001000000010
11101111011011101111001110111011111001000110111010111110111110011011110110011011111001111111101011101
00000100000010000000000100000001000000000000000000000100010000001000000100000000010000000100000000001
11101101110011010110101010110111111010101111011011101011110110110011110111011111101101011011110010111
00000100000000000000000000000000010010100000001000000000000000000001000000001000001001010000000000000
11110101110010111001111110001100101011111011111101101111011011101111011111001011101101001111101110110
10000000000000010000000000000000000000001000001001000100000000100000001000000000000001000000000000000
10111011101111101101011111011101111011111011111110111101110010110110111111010001111101101110100111110
10000001000000001000000001000000001000001000001000000000000010010000001000000000000101000000000000010
01111101011110110011101111101100111010010111111100100110101111100100101111010111011110101011101110110
00000000010000000000100010000000000000000000000000000010100000000000000000000000001000101000000000010
01101111110111100110111110111110011111010110111100110101110001111010111001111110110110101011010001110
00000000100000000010001000001000000001010000000000000000000000000010000000000000000000000000000000010
11101110101111011101111001110111001111111110101101110111011011111001101101111001110100111100011111011
00001000000001000000100000000001000000100000000101000000000010000001001000001000000000000000000000000
11101011111000111001111011101001101001011101011111000100111111100111011101111011011111010101111100110
10000001000000000000000000000000101000000000000000000000000001000000000000100010000000000000100000010
11110110001111101101110011001100001111011101110110001111010111111011101111111010100111011101111011101
00000000000000000000000000001000000000000000000000000000000010000010000100000000000100000000100010000
01010110110110111011111001101010110111110111101110111100011011101000101011011011100100111101100101111
01010000000000001010000001000000000001000100000000000000000000000000000001000000000000000000000000000
10111111010101110101001010111000111101110011111100111111110101011100010111001110011101111011101101111
00010000000000100000000000000000000000000000000000000100000001000000000000000000000000000000100100000
11000011011111101100110111011101101110101110111110101111011100110111100101101101001011101110100111110
10000000000000000000000000010000001000100010000000101000000000010000000000000000000000000000000000010
00011111100010111111111010011010111010111111010111100111110101010111110110111011011101111001010111101
00000000000000000001000000000000001000000001010010000000000101010000100000001000000000000000010100000
10111111110010001001111101110011010111101110010111111011110111011101011100110011101110111001110110111
00000000000000000000001001000000000000000100000000001000000000010000000000000000100100000000000010000
11000111111010111011001111001111100111111110101111111111000101111011011001111001111101101101110001111
00000000000000100000000001000000100000001000000001000000000000010010000000000000000001000000000000000
01111011110011110111001110100011010101111111101101101111011111010110111010101111100111010110111101110
00100001000000010001000000000000000000000000100000000010000000010010010010101000000001010000000100010
11001111001110011111011110010011011111110011110101110010101111111001110111010101101110111001011110101
00000000000100000000000000000000000100000001000100000000000000100000000000000000000100000000000000000
10110101011110111111110101000001101111111110101111101011010111100111111000111001001111111011011001111
00100000000010000100000000000000000000000100100010001000000000000000000000100000000000000010001000000
11101101101110110101110101111011111101010111111110010011111011011011110110111001111011111110010101111
00000101000000000000000100000000100001000000100000010000000001010010000100000000000010000000010100000
01011100110111111000100111001111011101011101111100011111110010011111111110101010111101110011110101110
01000100000000000000000000000000000101010000000000000100000000000001000000000010010000000000100000010
11011111101010101001111111010011111111011011011011101011110101001101110010111001001011111010111011110
00000100001010000000000001010000000010010000000000000001000101000000000000000000000000000000000000100
00111011101110111110010111111111111100101001001111111001110111010110111001111010110111010010110111110
00000000000010000010000000000000000000000000000100000000100001000000000000000010000000000000000000000
00011001101100011111101110010111111101011110111001110101110111010111011110010101111011110101100110110
00000000000000000000000000000000000100000000000000010100000000000100000000000100000010000000000010010
01100111111001111100011011100011101111011101101010101011110111010111101011101011011110111011111100101
00000000000000000000000000000000000100000001001010000000000000010001001000101001000010100001000000000
01110111101111011001101101011101111010101111110111011011101110011101111110110111101101101111101001101
01000010000000000001000000000100100010000001000000001000000000001000100000000100001000000000000000000
11011110010111111010101010111101111011011101110111011101001011110101111111001010111110100011111011110
00000000010010000000000010001001000000010000000100000000000000000100001000000000000000000000001000010
10110111101111111110100111101101110101111110011011001110011110111000111100111100111110111011011100110
00100000100000100000000010000001000100100000000010000000000000000000000100000000000000100000000000100
01110111101101110111111100111010110111011111010011111111100110111101100110111101111011111001101110111
01000000001000100000100000000000010001000001010000001000000010000100000000000000010000000000100100000
10111110111110110101111111000111111101111010110011011110110001110111101101011101110101011101110111110
00010000010000000100000100000000010000000000000000000000000001000010001001010000000000001001000010000
11110111011111001011110101110110010110110101110110111111100100110101111110110111001111110110111011011
00000100010000000000000000000000000000100000000000010000000000010100010000010000000001000100000001000
11010111011111010110101001101111101110101111011101111011011011110110101001111101101111010010110111101
10000000000100000010101000000000000000000100000001000001001001000010000000000000000000000000010100000
11111010111110101010111111100110111101001010111110110011010101101011101101110110110111011110010111101
00000000100000000010100000000100000000000000000000000000000000001000000000100000000000000000010000000
11011110111110011010110100111011111111000111110000101011000111111110111111100000100100011111111110110
00000100000000000000000000010000000000000000000000000001000000000010000000000000000000000000000000000
10101111100111000101111111111011100010110111101101111100011010110111110001011110111111100101110011111
00100000100000000000000000000000000010000001001000000000000000000000000001010000010000000000100000001
01110111101111011010110001011011111111011110111001110111011101011111010110010011111100011111000111101
00000001000000000010000000000000000001000000000000100000000100000000000000000000010000000000000000000
01111011101110101110001011010110111111111111100100110101011001111101011101101110101100100101111111110
01000001000100000000000000000000000010000000000000100101010000000000000001000000000100000000000000000
10111010010111110111101011011101111110110011011110111101111100100011111111011100111101110111011101011
00000000000000000010000000000100100000000001000100000100100000000000000100010000000000100100010000000
11110101110101011111010111011101101111110111011100010111011110100110101110111101010011111111011000110
00000100100100000010000000000001000010000000000000010000000100000000000000000001010000000000000000000
01111010111001111011010011111111111101011010111001011110111010110101101101110111011111010110011111110
00001010000000000000010000000010000000000000100000000000100000000000000000100100001000010000000000000
11010110111101111110101101110101101001010110111101001111011011011110011011111110011011101101011111011
00000010000100010000001000000000000000000000000000000010000000000000001001000000010001001000000010000
10110101101101101111110101001101111111100111101110101110111010111010111011011011111001111011101111001
00000000000100000000100000000000000010000000000000100000000000100000001010000000010000001000000000000
11011011011010111011110111101000111011011101101110110111011111110100010111001111111101101011111110100
00000001000000000001000000000000000001000100000010100001000000000000000001000000001000000000000000000
01110111001010101111101011110011110101100111001111010001111101110110010010101101111010101101110111101
00100000000000000000000010000000000100100000000000000000000000000010000000000000000000000000000000000
01100111111001111100011101111001110111101110111100111010100110001111111110011101110101111011111111000
00100000000000010000000000000000010000000100000000010000000000000000000000001000010100100001000000000
11110001101100111101111110110100111111011010111011101011011010100110111011100111110111001111010010111
00000000000000001000001000100000000000000010010010000001010010100000000000000000010000000000000000000
01011101111111110010110001110111011110011101110111111011101111001100111100111111101111001111111110101
00000000010000000000000000100000010000000100010000000010000000001000000000000010000100000000100000100
10011110111111011101110110011111100110111001101011110101110111010101111111101110101011111101100011101
00000000001000010000010000000000000000010000000000010000000001000000000010000000100000000000000000001
01001111001011111011101111100101110001110101011111110011110111011101110111100111111010000111010110111
00000000000000000000001000000000000000010100000001000000100001010000100000000000000000000000010100000
01101110111011110111111100010110110100111011001101111001110100111111011110100101111101110110111110011
00000000010000100100000000010000000000000000000000001000000000000001000100000000000100010010100000000
