00000000000010000100000000000001000000000100100000000001000000000000010000000000001000000000000000000
01111101101010011111011101100101011110010101010110110111110111011010111100011001110111110111101110100
00000000001000000000000101000000000000000000000000000000010000001010000000000000000000000100000000000
11011111001101111111001101101001011100011111011111110111111100110101111100111111011010111011001011110
00010000001000000000000000000001000100000000000010000010000000100100000000001000000000000000001001000
11110011011101011101011111111101110001001010010011111111100111111011110110110011111011101001111011110
00000001000000000101000000000000000000001000000000000001000000001010000000000000100000000000001010000
11010111100011011011110110110001111011011101110111110101011011101111011101001101010101110101111100111
00000001000000000000000010100000000000000000100100000000001010000000000000000001010101000000010000000
11111000101100101111111011010111110000111001101110101101011100100000111111110111011100111111100111100
10000000000000000000000000000000000000000000100100100000000000000000000000000000000000010000000000000
11011011011011100111110110011011011011111100011001111110110010111010101011111001011100101011001110111
00001010000000100000000000000000001000000000000000001000000000000000000000000000000000000000000000000
10110101011011110101111011111101011011111010010110111101111011010100110111001111110011111111011011101
00100100000000010000000001000000001000000000000000010000100001000000000000000000000000010000000010000
11110111101111000100110110111101101011000101011011011111111010101101111100110110111111100101111110111
00000000000000000000100000000001001000000000000000000000000000001001000000000010000000000100000100000
11011011001110111000001011000111111111011101101101110110110111111011100101111011101110111110101011110
00000000000010100000000000000000000000000000100000000000010000010000000000000010000000010000000000000
10110111111011010111111101110000011101110110110110101101100111101011111111101010100111010111010111011
00010000000010000000100000000000000000000000000000001000000000000000100000000000000100000000000001000
01011111011011011101110111011001111110001110111010111101111001101001111110111000111110111100111011011
00000000010000000001000000000001000000000010000000000000100000000000000100001000000000000000000001000
11011111110011111100101000110101011011100110110010011111111011101101010111110111110110101101110110111
00001000000000000000000000000001001010000000000000000000100000101000000000010000000000100000010100000
11001110101111011101111110100111111110000110110111111100101011010011101111100111101101011110111011110
00000000000001010000000000000100000000000010100010000000001001010000000001000000100100000000000001000
11011110111101100101000110111111110010100111011110111111001110100101111110010101100111100111101001111
00001000000000000101000000000000000000000000000010010000001000000000000000000000000000000000101000000
11101110111100111101010011110101100100011111110011101111011001111011111001010111101110111011100111011
10000000000000100000000000000001000000000000000000000001000000000001000000000001000100000000000100000
01111011110110110010011101111110110111100111011011011101011111011110001111001111000100111100110111011
00000001000000100000000000000000010000100000000000000101001000000000000000000000000000000000010000000
10111011011100011110111011010110111010111111011110111011011001111110110101110010111010111111010110111
10000000000000000000010010000000000010000010000100000000001000000100000000000000000000001000000100000
10111111101001111110110110110101011110000010110100101001111111011111111110000111011001111011010101111
00001000001000000100000010000000000000000000000000000000000000000000000000000000000000000000010000000
01111001101110110101110111100111110100111100111010100111111001101111010111001011111011101101011111010
00000000000000000001000000000010000000000000000000000000000000001000000000001000100000000000001000000
01011101111010011011110111011111010111111001000100111101111111101111101011110001110111110110110101011
01000000000000000000100010001000000010000000000000000000000100001000001010000000000000100100000000000
11110111101101010111011000111110110010111101011110011110011110100111010110111011101111010110111011011
00000100000000000000000000001000000000000101010000000000000000000100000010000001000010010100100000000
10111011100101110111001001111111101101111011111110011110011111001011000110011011110100111111110101110
00000000000000000100000000000001000100010001000000000000000000000000000100000000000100000001000000000
11011100110101111111110000111011011111111000000111010011111101011111101010001101011101111000110011110
00001000000000001000000000000001000000000000000000000000000000010000000000000000000000000000000000000
11111010011100000011011111011011111011110101011010001110101111111101011100111101111011001101110111110
00000000010000000000000000000000000000100101001010000000000000010000000000010000000000000100100000000
10110111101011011110111111011011011110111000111101111001011101101101111011011100101111111010111110011
00010100001000000100001000000001001000000000001000000000000000100000000000001000000000000010000000000
11101100111111100111010110010111100110110101111011101110101011111011100110101011111010110011111101111
00000000010000000000000000000000000000100000001000000010000000000000000100000000001000000000000100000
10101111101100110101001011101101011011101111010011100101110011111011111010001011011110101101010011111
00000000000000000000000000000000000000000000000010000000000000000010000000000000000000000000010000000
10111101110011010110010110111110111011101111011001001011101111110111110101111101111110101101010011101
00000000000000000000000000001000010000100000010000000000000000100010000100001000010000000000000000000
11010111101011101101101111011010011101101111110101011111011110011100101110111000011101011110010111110
00010100000001001000100001010000000000000010000000000100000000000000000100100000000000000000000000010
11011111100001111110101100110101000001111111100111010111011101111010110110001111101010110110110011111
00001000000000000000000000000000000000000000000001000000000000000000100000000000000000000000010000000
11101110100111010111110111001101110110111010110111011011101011101111111110010001011111001110111110111
00001000000000000000000000001000010000000000010000000001000000000000000000000001000100000010000100000
01111011000100110111011111011110000011110111110111101011011011011101101111101111011100101101111011110
01000000000000000000000100010000000000000000100010000001010000000001000000001000000000000001000010000
01111110010101010111010111101110111011111010110101111011001001111110011111110111010011011101011100111
01000000000100000000000000000010000001000000000000000000001000000000000010000000000000001000000000001
01110011100111111011001111101101101010101110111110110110111101101110011101101010001111110010111111011
00000000000000000000000100000000000000001000010000000100100001000000000000000000000000010000000000001
11100111111101111000001111111000010000111111111101110110111110011110101111001010111101011011101011110
00000001000000000000000010000000000000000000000000000100000000010000000000001010000101000000000000000
01111110111101110100101110100011011111110101001111010101101111011011111101010111100111111111011000110
00001000000000000000000000000001000000000000001000000000100000001010000000010100000001000000000000010
11101110110101100101110111110110111101110111110110111001011001111111101011100110111010011100110111110
10000000000000000000100000000100001000010000000100000000000000001000000000000100001000000000000000010
11011011010110011011111001110111010111010111001110010101110111110100111111111110011001110110111011101
00000001010100000000000000100000010000000000000000000000000001000000000100000000000001000100001000000
11111001100110111101110110001001011101111110001011111110011111111111100010111001001111111111101010101
00000000000000010000000000000000000000000100000000000100000000100000000010001000000000001000000000000
01110110111011011111100011101011010110111101011010111101101111010011101011000101011111111100101110101
00000000000000010000000000000001010100000100000000000000001000000000000000000000000000100000000010100
01011111011110111111100111110111101011100000101111110101111011111101110010111010111101011111011001111
00000010001000001000000000000000000000000000100000000100001000100000000000010000000000001000010000000
11011111010111110011010101110001111101000100111111110111111001001111010111101010100111110110101001111
00000100000010000000000000000000000001000000000000000000000000001000000000000000000010000000000000001
11101000011111101110110111111101100110100111111101111011011110011101110111001001001110111111110110100
00000000000000000100100000100000000000100000000001000000010000000001000000000000000000000000000000000
01111101010001101011011111001111010010011110101011111110111111011110101011110100101111110101111010110
01000000000000000000000100000010000000000000000000000010010000010000001000010100000000010000000000010
10111111011110011100010110111110110110011111011010111111011111010101011111100101111011000111101010110
00000100001000000000000000000010010100000001000000000010000000000001010000000001000000000000000000000
11011111001011011100111111011011110101101111010001111111011100111101100111011011111001000001101111101
00000000000010001000000000000010000100100100000000000000000000000000000000000000000000000000100001000
11111111101100101110110011010010101001111101101101100111100101001111010101111111100011110111111011100
10000000000000000000000000000000001000000000000000000000000000000000000100001000000000010001000000000
10111101101110001110101111011011111111111001110001011101001011111110011101011110011111011111011011110
00000000000000000010100001000000001000000000000000001000000000000000000100000000000001000100000000100
11101011010101101100011101111011111101011001111110011111011001111000111100011111001000111011110011110
00000010000000000000000000000001000001010000001000000000000000000000000000000000000000000001000000000
01011110101111010101111101111010101110101111011111010111110100101101111101111101011110100110101101111
01000100000000010100001000100010101000000001000100000010000000000000010000100001001000100000000000000
