00000000000000001000001000000000000001000000000000000000000000000010101000010010000000000000000000000
00111101111111011000101001101010011111101111011011011111010110111101110010110101111110110010011111001
00000000001000000000000000000000000000000000001000000000000100000000000000000101000000000000001000000
01110101001111011010111111101011010110011011111001011101111101111111111101001001101011001111110011111
01000000000001010000000010001010010000000000001000000000001000001000000000000000101010000000100000000
10111111010111101011011010111010010110111100010111010101010011111101110100011101011101111010101111101
00000100000000000000000000000000000100000000000000000000000000000000000000000100000000010010100000101
11100111101100111010010111011111011011011011101101101011010111101101011111110011101100101110111010101
00000000100000000000000000000000000000010001000000000001000000000001001000000000000000100000000000100
01110111100111111110110111110111010001001001011011110100101101111111110111111000111010111100011101101
01000001000000010000010100000000000000000000000000000000000000000010000000000000100000000000000101000
01111011011011101111011101000101111101111011101011111010011100111101110111100101001111111011100100110
00000000001000000010010000000000000000010010001000000000000000000001000000000100000000000000000000010
11111010111110010111101111110010001111011011111101011101011100111111110111100101010111110011110001011
00000000100000010010000000000000000010000000100001000100000000000001000000000001010000000000000000000
11011111101110110110101111010011101110011101111011111010111101011110000111101101111111100111001111011
00000100001000000000101000000000101000000000010000100000010000000010000000000000000000000000001000001
11101011101000110011110111011110101111001111101011100101111110110110110101111011010111001111101011101
00000000100000000000000000000010100001000000000001000000000010100010010100000010000001000000000000001
01101101110110110111011111101010101101010111111101110010101101111110110101110101010111110101101101111
01001000000100000010000000000000100000000000000000000000100100001000000000000101010000100000000000001
11011001110011011101010000111111011111011011011101110111111001100111111101000100000011011111101001011
00000000000000000000010000000000000001010001010000000000000000000000000000000000000000000000000001000
10111101101111001010100011101110111011100011011110100101111101111100111011101111011111011011110101101
00100000000000000000000000000000010010000000000010000000000000010000001000000001000000001010000000101
10111110110101001101110100000111111011011111001110101111111000011101101101011011100010111011111011011
00000000000000000000100000000000000000000000000100000000000000000001000000000001000000000000000001000
11111000101100100111111101111001111101101111010111101011011101110100111010111110111101110100110111011
00000000000100000000000000000001000001000010000001001010001000000000001000000100000000000000100100000
10110110101100111111011101101111011010011110010110011101111010111110111111001110111101010001101101111
00010000000000000000010000000000000000010000000000000000010000000010001000000010100000000000000000000
01101111011011101111011111111000110111011011111001011111001111110010111101011111011110110111101111110
00101000000001000000010000000000100000000010000000001000000000000010100001000000010000100010000100000
11010111110111011011010111101011011110110110111011110111110010110011111011001011001111011111011110010
00000001000010010000000000000001000000000010000000000100000010010000000000000000000001000000000000000
11010010110111110110101111111010110111011111101111100110111111011010111001110111111101011101110111011
00010000000000000010100010000000010001000100000100000000001000000000100000010000100001010001000001000
10110111011101011111010101111010110111011001101111110110111111010111100101110000111110111011011111101
00100000001000000100010100000010000001000000000001000010000100010001000000000000000000000000000100000
11000110011110011111101010101111111101011011011110111110000111101111010011101100011100111101101011110
00000000000000000000000010000001000000000010010000010000000000000000000000000000000000001001000000000
10101110111010111011111110100001111011111100010110101111000011111101110011111100110100111110111011101
00000010000000000000000000000001000000000000000100000000000000001000000000000000000000001000010000000
00111111100111111011101111001101001111101110110101101111001101010111101101001110110111110011110111110
00000000100000001000000001000000000000000000000100000000000000000000000100000000000000000000000100000
11100111011110100110101111101111111101100010101001111110100111110101110111011011010001111100101011111
00000010000100000000000000100001000000000000000000000010100000000000100000000010000000000000000000000
01111111100110011000011110111111011111101011011010011110001011111111101011110111100101111001110101110
00000000000000010000000000000000001000001000000000000000000000000010000001000000000101000000000000010
11011011101111000011111111101010101011111110101101111011100111101110110110111111000100111101101011101
00001000000000000000001000000000100000000100000000001000000000000100010010100000000000000100101000000
01110111110011111011101111101111010111101111111101110111100101111101111010101011110111110100011101110
00010010000000010001000010000100000001000001000001000001000000000001000000101000010100000000000000000
01110110111110011010110111100101111111010011110010100001111111110111011001110001001101111110011111101
00000010100000010000000001000000000000000001000000000000000000010100000000000000000000000010000000101
11011010011010111110111011100111101111101100110011011101011011111110100010111110111100011101101101110
00010000000000000000001001000000000000000000000000010000001000001000000000000000000000000100100000010
11110111110110010111111100110111001011101101100111111100100111101010111010101110101000101101111011111
00000100000000000001000000100010000000000000000000000000000000000000100000000010100000000000000000000
01011110011000111011010111101001110111111011111010011011010110010101101110110100101110011011011101110
01000000000000000000000000101000000000000000000000000000000000000000000000000000000000010001000100010
01111011101001011110111010001111110000110111111110010111111010011101111100110100111000110011111111101
00001000000000000000001000000000000000000000000100000000000010000000000000000000001000000000000000100
01101111010011111101100111100111111010111011001111011101011110110110111111100101101100111000010111111
01000010000000000000000100000001000000010010000001010000000010000000000000000001000000000000000000000
01101111010111011110111101000011101001111101111111011100011101111111101010100001110110111100111011110
01000000010010000010010000000000000000000000000100000000000101000000000000000000010010000000000010000
10111011011101111110110110010111111011001101111110001111100101111111010111011101111110010011101111010
00000010000100001000000000000001000001000000000000000010000000001000010010000001000000000001000000010
01010111101100111011011101111111011011101010101110100011101110101011101001001011010111111101110111011
00000000000000001010010000010000000000000000000000000001000000000001000000000000000000000100100100000
11001111001110011111011001111111011010110001111011101110111111101101101011100010111111011110111101101
00000000000000000010001000000001010010000000000000000010000010000000001000000000000000000100010000000
10111111011011010110010111110011010100111101100111101010011001101011101111111000110110110111110011101
00100000000000000000010000000000000000000000000010001010000000000000000000000000000000010000000000000
11001111111010111100100110111101010001111111011010010111111101101111101101010011110100011110101111110
00000000100000001000000000000000000000000000001010000000000001000000001000000000000000000000000000010
10111110010110111001110111101011111010111110111101000111101111111011011110111001110110101011111110110
00000000000000000001000010000001000010001000010000000000000001000010000000000000100010100000001000100
10010111111011000010111101111110011110011111011111001101001111111101001111111111101100101111101111100
00000000000010000000000000000100000000000010000000000101000000001001000000010000000000100001000000000
11110100101100111011101101111110110111001101110101101111011101011010111001111110100001001111101011011
00000000000000000001000000001000010100000000010000000000000000000000000000000000000000000001000000000
11001111001100111111011111101110100100001111111111111011001001000011110111101001111110001001101111111
00000000000000000010000000000000000000000000100000000000000000000000000001000000000010000000000000000
10101010011111110011011101011111110101110010111011010101101110110110011011000111101111010101010111111
10000000000000000000000100000010000000000000001000000000000000000000000000000000000010000000000000001
01101111101100110011111011100011111011101110011110111010101101101110110110111011101100111110011101110
00000010000000000000001000000000000000000100000000000010000000000000010000000000001000000000000000100
01011100011111101011011111011000111110110110001111011010101011111101110111010111010011111011111011101
00000000000000101000000000000000010000000000000010010000000000000001000000000010000000000000100001000
10101111011101010110101100110110010011110110111101110111100101110101110110010111111101111011011011101
00000000001001000000000000000000000000000000000000000000000100010000000000000000001000001001000000000
01111011110100111101111111011100111111011010111010100101010011111111101111111001010111011111001110110
00010000100000000000010000010000000100010010000000000000000000000000100010000001010001000000000100100
11011101101011111110101000111011110011110110101101110101111110101110111001011011100111001011101111011
00001000100000000000000000001001000000000010100000000000010000100000000000000000000000000000000100000
11100111100110111010100110110111111011001001111111111110111111110101100010110011011111010001100101000
00000000000000000000000000000100000000001000000100000000000000000000000000000000000000000000000000000
10101101001101111010110101111111010111010101101011011101111011101010111011111110011000101101111111010
00000000000000001010010000000100000000000100000000000100010001000000000001000000000000000000010000010
