000000000
011110110
010000100
011110011
001000000
011011110
001000000
101101011
000000000
