000000000
001111110
000000000
110111010
000000010
101110110
000010010
111001110
000000000
