000000000
110011011
000000000
001011111
000000000
010011111
000000000
110111101
100010000
