000000000
011011011
000000000
101011110
001010000
011011011
001000000
011010111
010000000
