000000000
011011101
001010000
011111011
000001000
011011110
000000000
111110101
100000100
