000000000
111100110
000000000
001111101
000000000
011111011
000000001
101110101
000000100
