000000000
001111101
000000100
101010111
000000000
111100101
000000101
101011110
001000000
