000000000
011110011
000000000
111111001
100000000
001110111
000000000
110011011
000000000
