000000000
011101110
000000010
001111110
000000000
110111101
000001000
011110110
000100010
