000000000
011111100
000000000
111111100
100000000
101101110
000000000
011111010
001000000
