000000000
001111110
000000010
111011110
000010000
010111011
000000000
110111101
100000000
