000000000
010111110
010000100
011110101
000000000
101110111
000000001
101101101
000000000
