000000000
011111001
001000000
101111001
001000000
111010011
000000000
101011011
000000000
