000000000
111110010
000000000
011111010
000000000
011001111
000000000
101011110
000000010
