000000000
010011111
010000000
100111110
000000000
110001111
000000000
111000111
000000000
