000000000
011011110
010000010
111101100
000000000
101101111
000100000
101110110
100100100
