000000000
110110110
000000000
110111110
000001000
101111101
000100000
011101111
000100000
