000000000
101101110
000000000
110101110
000000000
111011011
000010001
101111101
000010000
