000000000
111001011
000000000
011010111
010000000
101011011
001001000
111011011
000010000
