000000000
111010110
000010010
101110110
000000000
101011110
000000000
011101101
001000000
