000000000
010011111
000000000
011010111
001010000
011111010
000000000
011011011
001000000
