000000000
101101110
000000100
011010111
000000000
110111010
000000000
101111011
100000000
