000000000
011101011
000000000
101111110
000010000
101111001
000000000
011111010
000001010
