000000000
011110111
000000001
011111101
000001000
101100111
000000000
001111110
000000000
