000000000
100111011
000000000
101011101
000000000
001111110
000000010
110111001
000000000
