000000000
111011110
000010000
111010011
000000000
011101011
000000000
111101011
100000000
