000000000
011101110
000000000
101110110
001000000
101110110
001000000
011101011
001000000
