000000000
011111100
010000000
111101010
000000000
111110001
000000000
010111111
000000000
