000000000
001111011
000000000
101101101
000000101
011010111
010000000
111111010
100000000
