000000000
101010111
000000000
101111011
000001000
111001111
100000000
011011110
010000000
