000000000
101010111
000000000
111001111
100000000
110110111
000010000
011001111
000000000
