000000000
100101111
000000000
111101010
000000000
011101111
000100000
000111111
000000000
