000000000
001111110
000000000
011110111
000000001
111110100
000000000
101111010
000000000
