000000000
111001101
000000000
111101110
000001000
101010111
000000000
101110011
000000000
