000000000
011011110
000000000
111011101
000010000
011011011
010000000
011111101
000001000
