000000000
011011110
000000000
011011111
001000001
010111011
010100000
010011111
000000000
