000000000
011111100
001000000
101011110
000000000
111101101
000001000
111101110
000001000
