000000000
101101101
000000000
011101110
000000100
111100110
000000010
111101101
100000000
