000000000
011010111
001000000
110110110
000100010
111100110
000000000
010111101
010100000
