000000000
100111101
000000100
011010111
000000000
111011011
000010000
110111110
000010000
