000000000
101110101
001000000
111011100
000000000
011001111
000000000
110110110
000000000
