000000000
101111001
000000000
011111010
001000000
011011101
001000000
110011110
000000010
