000000000
011111101
000100000
001111101
000000000
011011110
000000000
010111011
000000000
