000000000
011111100
000000000
011111010
000000010
111001101
000000000
111100110
000000100
