000000000
001110111
000000000
011010111
000000000
011110101
000000000
010111110
000000000
