000000000
101110111
000010000
011011101
000000000
011011101
001000000
101110101
001000000
