000000000
101111101
000010000
101111100
101000000
111101010
000001010
111110001
000000000
