000000000
011011110
001000000
101111100
000000000
101111011
000001000
011101110
010000000
