000000000
001111110
000000000
110001111
000000000
101101101
000000100
001110111
000000000
