000000000
100111101
000000100
101100111
000000000
101101011
000000000
111101101
000001000
